"Município (Res)";"Branca";"Preta";"Amarela";"Parda";"Indígena";"Ignorado";"Total"
"110001 Alta Floresta D'Oeste";4;2;0;4;0;3;13
"110037 Alto Alegre dos Parecis";5;0;0;0;0;1;6
"110040 Alto Paraíso";10;1;1;9;0;6;27
"110034 Alvorada D'Oeste";2;0;0;3;0;5;10
"110002 Ariquemes";62;32;2;122;2;61;281
"110045 Buritis";8;1;1;16;0;11;37
"110003 Cabixi";1;1;0;0;0;1;3
"110060 Cacaulândia";1;0;0;2;0;2;5
"110004 Cacoal";57;4;0;54;0;42;157
"110070 Campo Novo de Rondônia";1;0;0;7;0;7;15
"110080 Candeias do Jamari";10;5;0;41;1;17;74
"110090 Castanheiras";0;0;0;3;0;2;5
"110005 Cerejeiras";11;4;0;10;0;6;31
"110092 Chupinguaia";5;2;0;5;0;6;18
"110006 Colorado do Oeste";10;6;0;7;0;4;27
"110007 Corumbiara";2;2;0;1;0;1;6
"110008 Costa Marques";1;1;0;11;1;6;20
"110094 Cujubim";0;2;0;10;0;5;17
"110009 Espigão D'Oeste";4;2;0;7;1;11;25
"110100 Governador Jorge Teixeira";0;0;0;3;0;2;5
"110010 Guajará-Mirim";23;2;0;50;1;32;108
"110110 Itapuã do Oeste";2;0;0;3;0;1;6
"110011 Jaru";8;3;1;29;1;26;68
"110012 Ji-Paraná";45;10;2;132;0;142;331
"110013 Machadinho D'Oeste";3;2;1;14;0;3;23
"110120 Ministro Andreazza";1;1;0;5;0;0;7
"110130 Mirante da Serra";2;1;0;2;0;3;8
"110140 Monte Negro";5;2;1;6;1;3;18
"110014 Nova Brasilândia D'Oeste";7;1;0;10;0;7;25
"110033 Nova Mamoré";5;3;0;17;0;6;31
"110143 Nova União";3;0;0;1;0;2;6
"110015 Ouro Preto do Oeste";7;5;1;27;0;22;62
"110145 Parecis";1;0;0;0;0;0;1
"110018 Pimenta Bueno";8;4;0;14;0;41;67
"110146 Pimenteiras do Oeste";0;0;0;0;0;1;1
"110020 Porto Velho";411;89;32;1595;3;921;3051
"110025 Presidente Médici";8;3;0;16;0;20;47
"110147 Primavera de Rondônia";0;0;0;1;0;1;2
"110026 Rio Crespo";1;0;0;1;0;2;4
"110028 Rolim de Moura";16;2;1;33;0;26;78
"110029 Santa Luzia D'Oeste";2;0;0;4;0;1;7
"110148 São Felipe D'Oeste";1;0;0;1;0;0;2
"110149 São Francisco do Guaporé";0;0;0;1;1;3;5
"110032 São Miguel do Guaporé";2;0;0;2;0;1;5
"110150 Seringueiras";0;0;0;3;0;0;3
"110155 Teixeirópolis";1;0;0;5;0;0;6
"110160 Theobroma";0;1;0;3;0;0;4
"110170 Urupá";0;0;0;3;0;2;5
"110175 Vale do Anari";0;0;0;0;0;1;1
"110180 Vale do Paraíso";0;0;0;1;0;1;2
"110030 Vilhena";154;23;3;76;0;82;338
"110000 Município ignorado - RO";2;0;0;1;0;2;5
"120001 Acrelândia";3;3;0;6;0;3;15
"120005 Assis Brasil";0;0;0;3;0;2;5
"120010 Brasiléia";3;0;0;8;0;4;15
"120013 Bujari";1;0;0;2;0;1;4
"120017 Capixaba";0;2;0;3;0;2;7
"120020 Cruzeiro do Sul";2;0;0;21;0;8;31
"120025 Epitaciolândia";1;2;0;4;0;3;10
"120033 Mâncio Lima";0;0;0;1;0;1;2
"120034 Manoel Urbano";0;1;0;15;2;3;21
"120035 Marechal Thaumaturgo";0;0;0;1;0;0;1
"120038 Plácido de Castro";0;0;0;9;0;5;14
"120080 Porto Acre";1;1;0;2;0;1;5
"120039 Porto Walter";1;0;0;0;0;0;1
"120040 Rio Branco";75;43;1;424;1;217;761
"120042 Rodrigues Alves";0;0;0;3;0;1;4
"120043 Santa Rosa do Purus";0;0;0;0;0;1;1
"120050 Sena Madureira";7;1;1;25;0;10;44
"120045 Senador Guiomard";1;4;0;17;0;8;30
"120060 Tarauacá";1;1;0;2;0;0;4
"120070 Xapuri";1;1;0;6;0;1;9
"130002 Alvarães";0;0;0;1;1;1;3
"130006 Amaturá";0;0;0;5;0;5;10
"130008 Anamã";0;0;0;1;0;1;2
"130010 Anori";0;0;0;2;0;2;4
"130014 Apuí";9;4;0;8;0;7;28
"130020 Atalaia do Norte";1;1;0;5;1;6;14
"130030 Autazes";6;0;0;17;1;9;33
"130040 Barcelos";3;0;0;4;0;3;10
"130050 Barreirinha";0;0;0;13;1;8;22
"130060 Benjamin Constant";3;3;0;59;12;16;93
"130063 Beruri";0;0;0;5;1;2;8
"130068 Boa Vista do Ramos";1;0;0;4;0;3;8
"130070 Boca do Acre";3;0;0;2;1;5;11
"130080 Borba";3;1;0;27;0;14;45
"130083 Caapiranga";1;0;0;2;0;0;3
"130090 Canutama";1;0;0;2;0;1;4
"130100 Carauari";1;0;0;5;0;8;14
"130110 Careiro";1;1;0;24;0;6;32
"130115 Careiro da Várzea";1;0;0;9;0;4;14
"130120 Coari";0;0;0;26;0;44;70
"130130 Codajás";0;0;1;5;0;4;10
"130140 Eirunepé";2;0;0;4;1;10;17
"130150 Envira";1;0;0;0;0;0;1
"130160 Fonte Boa";0;0;0;10;1;7;18
"130170 Humaitá";8;4;1;54;2;12;81
"130185 Iranduba";7;1;1;57;2;43;111
"130190 Itacoatiara";13;3;1;118;2;54;191
"130195 Itamarati";2;0;0;0;0;0;2
"130200 Itapiranga";0;0;0;4;0;3;7
"130210 Japurá";1;1;0;3;0;0;5
"130230 Jutaí";0;0;0;1;0;4;5
"130240 Lábrea";3;0;0;5;2;4;14
"130250 Manacapuru";6;2;1;86;1;57;153
"130255 Manaquiri";1;0;0;10;0;5;16
"130260 Manaus";1120;194;47;6639;48;5075;13123
"130270 Manicoré";3;2;0;26;0;15;46
"130280 Maraã";0;0;0;6;1;1;8
"130290 Maués";5;0;0;37;0;22;64
"130300 Nhamundá";0;0;0;2;0;1;3
"130310 Nova Olinda do Norte";1;0;0;8;0;10;19
"130320 Novo Airão";1;1;0;16;1;8;27
"130330 Novo Aripuanã";1;0;0;7;0;1;9
"130340 Parintins";19;3;0;187;3;63;275
"130350 Pauini";0;0;0;1;0;0;1
"130353 Presidente Figueiredo";4;3;1;30;1;25;64
"130356 Rio Preto da Eva";6;2;0;31;1;20;60
"130360 Santa Isabel do Rio Negro";0;0;0;1;0;0;1
"130370 Santo Antônio do Içá";0;2;0;10;2;7;21
"130380 São Gabriel da Cachoeira";3;1;0;3;2;6;15
"130390 São Paulo de Olivença";0;0;0;14;4;23;41
"130395 São Sebastião do Uatumã";0;0;0;3;0;2;5
"130400 Silves";0;0;0;5;0;0;5
"130406 Tabatinga";15;4;1;117;7;92;236
"130410 Tapauá";0;0;0;1;0;1;2
"130420 Tefé";1;2;0;98;5;76;182
"130423 Tonantins";0;0;0;3;0;2;5
"130426 Uarini";0;0;0;8;0;2;10
"130430 Urucará";0;0;0;6;0;2;8
"130440 Urucurituba";1;0;0;17;0;6;24
"130000 Município ignorado - AM";1;0;0;2;0;1;4
"140005 Alto Alegre";1;1;0;5;1;2;10
"140002 Amajari";2;0;0;4;0;2;8
"140010 Boa Vista";208;85;11;839;41;558;1742
"140015 Bonfim";3;2;0;8;11;10;34
"140017 Cantá";1;1;1;9;2;10;24
"140020 Caracaraí";2;2;0;15;1;11;31
"140023 Caroebe";0;0;0;6;1;1;8
"140028 Iracema";0;0;0;3;0;4;7
"140030 Mucajaí";4;4;1;27;1;14;51
"140040 Normandia";0;0;0;3;3;1;7
"140045 Pacaraima";4;0;0;6;6;9;25
"140047 Rorainópolis";7;1;0;18;0;7;33
"140050 São João da Baliza";1;0;0;7;0;9;17
"140060 São Luiz";0;2;0;3;0;0;5
"140070 Uiramutã";2;0;0;2;0;0;4
"140000 Município ignorado - RR";2;3;0;0;0;1;6
"150010 Abaetetuba";10;4;1;90;0;127;232
"150013 Abel Figueiredo";1;0;0;1;0;6;8
"150020 Acará";0;1;1;18;0;14;34
"150030 Afuá";0;2;0;6;0;0;8
"150034 Água Azul do Norte";1;0;0;0;0;2;3
"150040 Alenquer";0;0;0;9;0;20;29
"150050 Almeirim";2;0;0;5;0;12;19
"150060 Altamira";10;5;0;47;0;88;150
"150070 Anajás";0;1;0;5;0;3;9
"150080 Ananindeua";174;38;3;706;2;1277;2200
"150085 Anapu";0;1;0;10;0;14;25
"150090 Augusto Corrêa";0;0;0;16;0;70;86
"150095 Aurora do Pará";0;1;0;2;0;6;9
"150100 Aveiro";0;0;0;3;0;3;6
"150110 Bagre";1;0;0;3;0;3;7
"150120 Baião";0;0;0;18;0;14;32
"150125 Bannach";0;0;0;2;0;1;3
"150130 Barcarena";6;3;0;73;0;178;260
"150140 Belém";391;158;8;2372;7;6400;9336
"150145 Belterra";1;0;0;7;0;6;14
"150150 Benevides";5;2;0;53;0;90;150
"150157 Bom Jesus do Tocantins";0;0;0;2;0;5;7
"150160 Bonito";1;0;0;2;0;2;5
"150170 Bragança";9;2;0;62;0;231;304
"150172 Brasil Novo";1;0;0;2;0;7;10
"150175 Brejo Grande do Araguaia";0;0;0;4;0;2;6
"150178 Breu Branco";1;0;0;27;0;58;86
"150180 Breves";2;1;0;19;0;19;41
"150190 Bujaru";1;1;0;25;0;29;56
"150200 Cachoeira do Arari";0;0;0;8;0;7;15
"150195 Cachoeira do Piriá";1;0;0;8;1;22;32
"150210 Cametá";1;2;1;18;0;30;52
"150215 Canaã dos Carajás";3;4;0;47;0;25;79
"150220 Capanema";9;0;0;32;0;66;107
"150230 Capitão Poço";0;1;0;22;0;17;40
"150240 Castanhal";31;13;0;174;1;335;554
"150250 Chaves";0;0;0;1;0;2;3
"150260 Colares";0;0;0;10;0;9;19
"150270 Conceição do Araguaia";3;0;0;21;0;28;52
"150275 Concórdia do Pará";0;0;0;9;0;11;20
"150276 Cumaru do Norte";1;2;0;9;0;12;24
"150277 Curionópolis";4;6;0;30;0;29;69
"150280 Curralinho";0;0;0;6;0;4;10
"150285 Curuá";0;0;0;3;0;6;9
"150290 Curuçá";1;1;0;34;0;31;67
"150293 Dom Eliseu";3;3;0;31;0;56;93
"150295 Eldorado dos Carajás";3;5;0;41;0;33;82
"150300 Faro";0;0;0;4;0;0;4
"150304 Floresta do Araguaia";3;1;0;7;0;13;24
"150307 Garrafão do Norte";0;0;0;9;0;3;12
"150309 Goianésia do Pará";4;1;1;24;1;40;71
"150310 Gurupá";1;1;0;14;0;10;26
"150320 Igarapé-Açu";5;0;0;25;0;22;52
"150330 Igarapé-Miri";1;1;0;10;0;27;39
"150340 Inhangapi";1;0;0;3;0;4;8
"150345 Ipixuna do Pará";1;2;0;15;0;26;44
"150350 Irituia";2;2;0;7;0;19;30
"150360 Itaituba";10;8;0;84;1;158;261
"150370 Itupiranga";2;3;0;17;0;35;57
"150375 Jacareacanga";0;0;0;3;0;10;13
"150380 Jacundá";1;0;0;43;0;61;105
"150390 Juruti";0;0;0;17;0;9;26
"150400 Limoeiro do Ajuru";0;0;0;6;0;5;11
"150405 Mãe do Rio";3;1;0;40;0;26;70
"150410 Magalhães Barata";0;0;0;6;0;3;9
"150420 Marabá";16;10;1;286;2;532;847
"150430 Maracanã";1;0;1;15;0;13;30
"150440 Marapanim";4;1;0;17;0;25;47
"150442 Marituba";29;5;0;186;0;276;496
"150445 Medicilândia";0;1;0;5;0;7;13
"150450 Melgaço";0;1;0;0;0;0;1
"150460 Mocajuba";0;0;0;7;0;4;11
"150470 Moju";0;0;0;26;0;39;65
"150480 Monte Alegre";0;0;0;17;0;19;36
"150490 Muaná";0;0;0;9;0;15;24
"150495 Nova Esperança do Piriá";0;0;0;1;0;0;1
"150497 Nova Ipixuna";1;0;0;7;0;11;19
"150500 Nova Timboteua";0;0;0;3;0;7;10
"150503 Novo Progresso";6;2;3;38;1;48;98
"150506 Novo Repartimento";2;3;0;42;0;53;100
"150510 Óbidos";0;0;0;39;0;52;91
"150520 Oeiras do Pará";0;0;0;5;0;5;10
"150530 Oriximiná";6;1;0;40;0;30;77
"150540 Ourém";0;0;0;5;0;11;16
"150543 Ourilândia do Norte";2;1;0;19;1;24;47
"150548 Pacajá";3;0;0;16;0;34;53
"150549 Palestina do Pará";0;0;0;3;0;4;7
"150550 Paragominas";19;12;0;129;1;148;309
"150553 Parauapebas";31;42;0;350;1;194;618
"150555 Pau D'Arco";0;0;0;5;0;3;8
"150560 Peixe-Boi";1;0;0;5;0;3;9
"150563 Piçarra";3;1;0;6;0;7;17
"150565 Placas";0;0;0;7;0;6;13
"150570 Ponta de Pedras";1;2;0;14;0;8;25
"150580 Portel";1;0;0;4;0;3;8
"150590 Porto de Moz";0;0;0;4;0;1;5
"150600 Prainha";0;0;0;3;0;10;13
"150610 Primavera";0;0;0;9;0;17;26
"150611 Quatipuru";2;0;0;12;0;10;24
"150613 Redenção";22;14;1;105;0;171;313
"150616 Rio Maria";1;1;0;23;0;19;44
"150618 Rondon do Pará";0;2;0;22;0;51;75
"150619 Rurópolis";0;0;0;6;0;8;14
"150620 Salinópolis";1;0;0;31;0;38;70
"150630 Salvaterra";2;2;0;15;0;16;35
"150635 Santa Bárbara do Pará";3;1;0;11;0;18;33
"150640 Santa Cruz do Arari";0;1;0;2;0;3;6
"150650 Santa Isabel do Pará";6;3;0;36;0;65;110
"150655 Santa Luzia do Pará";0;1;0;5;0;2;8
"150658 Santa Maria das Barreiras";0;0;0;4;0;6;10
"150660 Santa Maria do Pará";3;2;1;24;0;36;66
"150670 Santana do Araguaia";5;1;0;36;0;30;72
"150680 Santarém";15;10;0;422;2;392;841
"150690 Santarém Novo";0;0;1;3;0;9;13
"150700 Santo Antônio do Tauá";3;0;0;22;0;14;39
"150710 São Caetano de Odivelas";3;1;0;18;0;13;35
"150715 São Domingos do Araguaia";0;1;0;14;0;19;34
"150720 São Domingos do Capim";0;1;0;11;0;10;22
"150730 São Félix do Xingu";5;4;0;58;0;60;127
"150740 São Francisco do Pará";1;0;0;8;0;15;24
"150745 São Geraldo do Araguaia";1;4;0;24;0;15;44
"150746 São João da Ponta";0;1;0;3;0;1;5
"150747 São João de Pirabas";0;0;0;13;0;12;25
"150750 São João do Araguaia";1;0;0;4;0;7;12
"150760 São Miguel do Guamá";2;4;1;45;0;55;107
"150770 São Sebastião da Boa Vista";2;0;0;7;0;8;17
"150775 Sapucaia";0;0;0;7;0;5;12
"150780 Senador José Porfírio";0;1;0;2;0;2;5
"150790 Soure";2;5;0;19;0;19;45
"150795 Tailândia";7;5;0;72;1;79;164
"150796 Terra Alta";0;1;0;5;0;3;9
"150797 Terra Santa";0;0;0;5;0;5;10
"150800 Tomé-Açu";4;4;0;38;0;43;89
"150803 Tracuateua";3;0;0;4;0;16;23
"150805 Trairão";0;1;0;3;0;6;10
"150808 Tucumã";3;0;0;22;0;43;68
"150810 Tucuruí";14;11;0;121;0;224;370
"150812 Ulianópolis";2;1;0;17;0;22;42
"150815 Uruará";0;2;0;9;0;14;25
"150820 Vigia";11;0;0;42;0;45;98
"150830 Viseu";0;0;0;12;0;26;38
"150835 Vitória do Xingu";0;0;0;3;0;4;7
"150840 Xinguara";2;0;0;23;0;27;52
"150000 Município ignorado - PA";1;0;0;0;0;1;2
"160010 Amapá";0;0;0;1;0;5;6
"160020 Calçoene";0;2;1;17;0;14;34
"160021 Cutias";0;0;0;4;0;2;6
"160023 Ferreira Gomes";0;1;0;5;0;2;8
"160025 Itaubal";0;0;0;4;0;1;5
"160027 Laranjal do Jari";4;3;0;31;0;31;69
"160030 Macapá";190;54;1;601;0;622;1468
"160040 Mazagão";1;1;0;8;0;6;16
"160050 Oiapoque";6;8;0;45;8;44;111
"160015 Pedra Branca do Amapari";0;0;0;10;0;5;15
"160053 Porto Grande";2;0;0;11;0;4;17
"160060 Santana";23;8;0;102;0;60;193
"160005 Serra do Navio";0;0;0;1;0;2;3
"160070 Tartarugalzinho";1;0;0;6;0;6;13
"160080 Vitória do Jari";1;1;0;7;0;14;23
"170030 Aguiarnópolis";0;0;0;14;0;9;23
"170035 Aliança do Tocantins";3;3;0;4;1;8;19
"170040 Almas";1;0;0;3;0;2;6
"170070 Alvorada";2;0;0;9;0;3;14
"170100 Ananás";0;2;0;8;0;9;19
"170105 Angico";0;0;0;1;0;0;1
"170110 Aparecida do Rio Negro";0;0;0;1;0;0;1
"170130 Aragominas";0;0;0;2;1;0;3
"170190 Araguacema";1;1;0;3;0;3;8
"170200 Araguaçu";0;0;0;5;0;3;8
"170210 Araguaína";58;7;1;236;2;153;457
"170215 Araguanã";0;0;0;4;0;1;5
"170220 Araguatins";7;2;0;29;0;18;56
"170230 Arapoema";0;1;0;7;0;3;11
"170240 Arraias";0;0;0;0;0;1;1
"170255 Augustinópolis";2;0;0;12;0;7;21
"170270 Aurora do Tocantins";0;0;0;1;0;1;2
"170290 Axixá do Tocantins";2;0;0;12;0;7;21
"170300 Babaçulândia";0;0;0;8;0;3;11
"170305 Bandeirantes do Tocantins";0;0;0;1;0;0;1
"170307 Barra do Ouro";0;0;0;1;0;1;2
"170310 Barrolândia";2;0;0;4;0;5;11
"170320 Bernardo Sayão";0;1;0;4;0;1;6
"170330 Bom Jesus do Tocantins";0;0;0;2;0;0;2
"170360 Brasilândia do Tocantins";0;0;0;4;0;0;4
"170370 Brejinho de Nazaré";1;1;0;3;0;1;6
"170380 Buriti do Tocantins";1;0;0;2;0;1;4
"170384 Campos Lindos";0;1;0;1;0;0;2
"170386 Cariri do Tocantins";0;0;0;2;0;1;3
"170388 Carmolândia";0;0;0;2;0;1;3
"170389 Carrasco Bonito";0;0;0;2;0;0;2
"170390 Caseara";0;0;0;1;0;3;4
"170510 Chapada da Natividade";0;1;0;2;0;0;3
"170460 Chapada de Areia";0;0;0;5;0;0;5
"170550 Colinas do Tocantins";13;1;0;29;0;19;62
"171670 Colméia";1;0;1;3;0;10;15
"170555 Combinado";0;1;0;0;0;1;2
"170560 Conceição do Tocantins";0;0;0;1;0;1;2
"170600 Couto de Magalhães";0;0;0;7;0;4;11
"170610 Cristalândia";2;2;0;4;0;2;10
"170650 Darcinópolis";0;0;0;8;0;1;9
"170700 Dianópolis";1;4;0;12;0;8;25
"170710 Divinópolis do Tocantins";0;0;0;2;0;3;5
"170720 Dois Irmãos do Tocantins";0;0;0;1;0;2;3
"170730 Dueré";0;0;0;2;0;0;2
"170740 Esperantina";1;0;0;8;0;3;12
"170755 Fátima";0;0;0;1;0;1;2
"170765 Figueirópolis";1;0;0;4;0;4;9
"170770 Filadélfia";1;0;0;5;1;2;9
"170820 Formoso do Araguaia";3;1;0;8;0;9;21
"170825 Fortaleza do Tabocão";1;1;0;4;0;1;7
"170830 Goianorte";0;0;0;1;0;0;1
"170900 Goiatins";0;0;0;6;0;5;11
"170930 Guaraí";3;2;0;32;0;14;51
"170950 Gurupi";37;13;1;64;2;60;177
"170980 Ipueiras";0;0;0;0;0;2;2
"171050 Itacajá";0;0;0;2;0;0;2
"171070 Itaguatins";0;0;0;1;0;2;3
"171150 Jaú do Tocantins";0;0;0;0;0;2;2
"171190 Lagoa da Confusão";1;0;0;5;7;7;20
"171200 Lajeado";1;0;0;1;0;3;5
"171245 Luzinópolis";0;0;0;2;0;0;2
"171250 Marianópolis do Tocantins";0;0;2;0;0;5;7
"171270 Mateiros";0;1;0;0;0;0;1
"171280 Maurilândia do Tocantins";0;0;0;1;0;0;1
"171320 Miracema do Tocantins";5;1;0;17;0;12;35
"171330 Miranorte";5;2;0;8;0;9;24
"171360 Monte do Carmo";1;0;0;1;0;0;2
"171370 Monte Santo do Tocantins";0;0;0;1;0;0;1
"171395 Muricilândia";0;0;0;1;0;2;3
"171420 Natividade";0;2;0;2;0;5;9
"171430 Nazaré";0;0;0;2;0;3;5
"171488 Nova Olinda";2;0;0;10;0;7;19
"171500 Nova Rosalândia";0;0;0;0;0;3;3
"171510 Novo Acordo";0;0;0;1;0;2;3
"171515 Novo Alegre";0;0;0;1;0;0;1
"171525 Novo Jardim";0;0;0;3;0;0;3
"172100 Palmas";190;47;0;247;0;231;715
"171570 Palmeirante";0;0;0;4;0;1;5
"171380 Palmeiras do Tocantins";1;0;0;4;0;1;6
"171575 Palmeirópolis";1;0;0;2;0;2;5
"171610 Paraíso do Tocantins";7;2;1;23;0;33;66
"171620 Paranã";0;1;0;0;0;0;1
"171630 Pau D'Arco";1;0;0;1;0;2;4
"171650 Pedro Afonso";1;1;0;5;0;6;13
"171660 Peixe";0;2;0;6;0;7;15
"171665 Pequizeiro";0;1;0;3;0;1;5
"171720 Piraquê";0;0;0;4;0;1;5
"171750 Pium";0;1;0;2;0;1;4
"171780 Ponte Alta do Bom Jesus";1;2;0;1;0;0;4
"171790 Ponte Alta do Tocantins";0;0;0;1;0;0;1
"171820 Porto Nacional";7;6;2;15;0;34;64
"171830 Praia Norte";3;0;0;4;0;1;8
"171840 Presidente Kennedy";2;0;0;5;0;1;8
"171845 Pugmil";0;0;0;7;0;1;8
"171855 Riachinho";1;0;0;1;0;0;2
"171870 Rio dos Bois";0;0;0;1;0;0;1
"171875 Rio Sono";0;0;0;1;0;1;2
"171880 Sampaio";0;0;0;4;0;1;5
"171886 Santa Fé do Araguaia";1;0;0;8;0;0;9
"171888 Santa Maria do Tocantins";0;0;0;1;0;0;1
"171889 Santa Rita do Tocantins";1;0;0;1;0;0;2
"171890 Santa Rosa do Tocantins";1;0;0;3;0;1;5
"171900 Santa Tereza do Tocantins";0;0;0;3;0;1;4
"172000 Santa Terezinha do Tocantins";0;0;0;0;0;2;2
"172010 São Bento do Tocantins";1;0;0;1;0;3;5
"172015 São Félix do Tocantins";0;0;0;0;0;1;1
"172020 São Miguel do Tocantins";1;1;0;6;0;12;20
"172025 São Salvador do Tocantins";1;2;0;1;0;0;4
"172030 São Sebastião do Tocantins";0;0;0;3;0;7;10
"172049 São Valério da Natividade";0;0;0;0;0;2;2
"172065 Silvanópolis";0;0;0;1;0;2;3
"172080 Sítio Novo do Tocantins";1;1;0;5;0;4;11
"172085 Sucupira";0;1;0;1;0;0;2
"172090 Taguatinga";2;3;0;7;0;2;14
"172093 Taipas do Tocantins";0;0;0;0;0;1;1
"172097 Talismã";0;0;0;3;0;1;4
"172110 Tocantínia";1;1;0;3;1;5;11
"172120 Tocantinópolis";3;0;0;21;0;11;35
"172130 Tupiratins";1;0;0;0;0;0;1
"172208 Wanderlândia";4;3;1;21;0;8;37
"172210 Xambioá";3;2;0;14;0;8;27
"170000 Município ignorado - TO";0;0;0;0;0;1;1
"210005 Açailândia";26;4;0;108;0;104;242
"210010 Afonso Cunha";1;0;0;3;0;2;6
"210015 Água Doce do Maranhão";2;0;0;3;0;4;9
"210020 Alcântara";1;1;0;9;0;6;17
"210030 Aldeias Altas";0;1;0;17;0;15;33
"210040 Altamira do Maranhão";1;0;0;2;0;3;6
"210043 Alto Alegre do Maranhão";10;7;0;47;1;44;109
"210047 Alto Alegre do Pindaré";0;0;0;4;0;0;4
"210050 Alto Parnaíba";1;0;0;2;0;2;5
"210055 Amapá do Maranhão";0;0;0;3;0;3;6
"210060 Amarante do Maranhão";1;0;0;6;0;6;13
"210070 Anajatuba";0;1;0;4;0;1;6
"210080 Anapurus";1;0;1;3;0;2;7
"210083 Apicum-Açu";4;1;0;15;0;9;29
"210087 Araguanã";0;0;0;10;1;7;18
"210090 Araioses";0;1;0;8;0;12;21
"210095 Arame";0;1;0;3;0;4;8
"210100 Arari";5;1;0;22;0;16;44
"210110 Axixá";0;1;0;10;0;11;22
"210120 Bacabal";37;55;0;112;1;180;385
"210125 Bacabeira";3;3;0;16;0;12;34
"210130 Bacuri";1;1;0;15;0;11;28
"210135 Bacurituba";0;0;0;1;0;3;4
"210140 Balsas";18;4;0;69;0;50;141
"210150 Barão de Grajaú";1;0;0;4;0;8;13
"210160 Barra do Corda";25;7;1;103;3;68;207
"210170 Barreirinhas";8;1;0;52;0;24;85
"210177 Bela Vista do Maranhão";0;1;0;3;0;6;10
"210173 Belágua";0;0;0;1;0;3;4
"210180 Benedito Leite";1;0;0;2;0;2;5
"210190 Bequimão";0;2;0;7;0;9;18
"210193 Bernardo do Mearim";1;0;0;2;0;1;4
"210197 Boa Vista do Gurupi";0;0;0;6;0;3;9
"210200 Bom Jardim";1;1;0;14;2;13;31
"210203 Bom Jesus das Selvas";0;3;0;17;1;25;46
"210207 Bom Lugar";3;0;0;3;0;1;7
"210210 Brejo";3;1;0;8;0;10;22
"210215 Brejo de Areia";0;0;0;3;0;1;4
"210220 Buriti";2;0;0;2;0;6;10
"210230 Buriti Bravo";1;0;0;3;0;9;13
"210232 Buriticupu";8;3;0;65;0;59;135
"210235 Buritirana";2;0;0;5;0;5;12
"210237 Cachoeira Grande";0;1;0;2;0;3;6
"210240 Cajapió";0;0;0;3;0;1;4
"210250 Cajari";0;0;0;3;0;2;5
"210255 Campestre do Maranhão";2;0;0;9;0;14;25
"210260 Cândido Mendes";0;0;0;4;0;1;5
"210270 Cantanhede";2;1;0;7;0;11;21
"210275 Capinzal do Norte";1;1;0;6;0;3;11
"210280 Carolina";4;1;0;23;0;5;33
"210290 Carutapera";0;0;0;15;0;8;23
"210300 Caxias";31;46;2;194;1;245;519
"210310 Cedral";0;0;0;7;0;8;15
"210312 Central do Maranhão";0;0;0;1;0;3;4
"210315 Centro do Guilherme";0;0;0;11;0;2;13
"210317 Centro Novo do Maranhão";3;1;0;8;0;6;18
"210320 Chapadinha";3;1;1;21;0;30;56
"210325 Cidelândia";4;0;0;10;0;8;22
"210330 Codó";17;27;0;160;0;182;386
"210340 Coelho Neto";2;16;0;92;0;63;173
"210350 Colinas";2;5;0;32;0;31;70
"210355 Conceição do Lago-Açu";1;4;0;9;0;9;23
"210360 Coroatá";5;10;0;41;0;43;99
"210370 Cururupu";2;10;0;12;0;21;45
"210375 Davinópolis";3;1;0;19;0;16;39
"210380 Dom Pedro";2;1;0;13;0;12;28
"210390 Duque Bacelar";0;0;0;4;0;4;8
"210400 Esperantinópolis";1;1;0;20;1;13;36
"210405 Estreito";6;4;0;30;0;24;64
"210407 Feira Nova do Maranhão";1;0;0;0;0;0;1
"210408 Fernando Falcão";2;0;0;0;0;0;2
"210409 Formosa da Serra Negra";0;0;0;4;0;1;5
"210410 Fortaleza dos Nogueiras";0;0;0;2;0;4;6
"210420 Fortuna";1;1;1;4;0;8;15
"210430 Godofredo Viana";0;0;0;4;0;3;7
"210440 Gonçalves Dias";1;2;0;3;0;4;10
"210450 Governador Archer";1;0;0;8;0;3;12
"210455 Governador Edison Lobão";3;0;0;8;0;7;18
"210460 Governador Eugênio Barros";0;4;0;6;0;15;25
"210462 Governador Luiz Rocha";0;1;0;4;0;8;13
"210465 Governador Newton Bello";0;0;0;1;0;1;2
"210467 Governador Nunes Freire";1;2;0;24;0;11;38
"210470 Graça Aranha";0;0;0;0;0;1;1
"210480 Grajaú";6;4;0;19;0;21;50
"210490 Guimarães";0;0;0;11;0;11;22
"210500 Humberto de Campos";2;0;0;19;0;22;43
"210510 Icatu";1;0;0;13;0;12;26
"210515 Igarapé do Meio";1;0;0;4;0;4;9
"210520 Igarapé Grande";2;1;0;5;0;4;12
"210530 Imperatriz";154;34;3;455;1;597;1244
"210535 Itaipava do Grajaú";0;1;0;4;0;3;8
"210540 Itapecuru Mirim";5;7;0;42;0;64;118
"210542 Itinga do Maranhão";7;2;0;26;0;32;67
"210545 Jatobá";0;0;0;4;0;2;6
"210547 Jenipapo dos Vieiras";0;0;0;3;0;1;4
"210550 João Lisboa";2;0;0;18;0;14;34
"210560 Joselândia";3;2;0;5;0;3;13
"210565 Junco do Maranhão";0;1;0;5;0;4;10
"210570 Lago da Pedra";3;2;0;32;0;19;56
"210580 Lago do Junco";0;0;0;5;0;1;6
"210594 Lago dos Rodrigues";1;0;0;2;0;3;6
"210590 Lago Verde";3;3;1;6;0;11;24
"210592 Lagoa do Mato";1;0;0;4;0;2;7
"210596 Lagoa Grande do Maranhão";0;0;0;2;0;0;2
"210598 Lajeado Novo";0;0;0;1;0;1;2
"210600 Lima Campos";4;4;0;6;0;1;15
"210610 Loreto";2;0;0;0;0;3;5
"210620 Luís Domingues";1;0;0;4;0;3;8
"210630 Magalhães de Almeida";2;0;0;4;0;3;9
"210632 Maracaçumé";0;0;0;11;0;20;31
"210635 Marajá do Sena";0;0;0;2;0;0;2
"210637 Maranhãozinho";0;0;0;7;0;12;19
"210640 Mata Roma";0;1;0;1;0;3;5
"210650 Matinha";0;1;0;5;0;4;10
"210660 Matões";0;1;0;12;0;10;23
"210663 Matões do Norte";0;0;0;6;0;4;10
"210667 Milagres do Maranhão";0;0;0;0;0;1;1
"210670 Mirador";0;2;0;2;0;12;16
"210675 Miranda do Norte";9;6;0;31;0;30;76
"210680 Mirinzal";1;4;0;9;0;7;21
"210690 Monção";1;0;0;5;0;2;8
"210700 Montes Altos";3;3;0;7;0;2;15
"210710 Morros";3;0;0;11;0;17;31
"210720 Nina Rodrigues";1;0;0;2;0;3;6
"210730 Nova Iorque";0;0;0;0;0;2;2
"210735 Nova Olinda do Maranhão";1;2;0;6;1;4;14
"210740 Olho d'Água das Cunhãs";2;2;0;9;0;13;26
"210745 Olinda Nova do Maranhão";1;1;0;3;0;5;10
"210750 Paço do Lumiar";24;19;0;131;1;148;323
"210760 Palmeirândia";1;1;0;6;0;6;14
"210770 Paraibano";3;1;0;11;0;6;21
"210780 Parnarama";0;0;0;13;0;11;24
"210790 Passagem Franca";1;0;0;14;0;5;20
"210800 Pastos Bons";0;0;0;2;0;4;6
"210805 Paulino Neves";1;1;0;8;0;17;27
"210810 Paulo Ramos";0;1;0;3;0;2;6
"210820 Pedreiras";18;18;1;68;1;75;181
"210825 Pedro do Rosário";1;0;0;9;0;9;19
"210830 Penalva";0;0;0;13;0;12;25
"210840 Peri Mirim";3;1;0;1;0;0;5
"210845 Peritoró";3;1;0;20;0;13;37
"210850 Pindaré-Mirim";2;2;0;9;1;21;35
"210860 Pinheiro";13;15;0;61;0;63;152
"210870 Pio XII";5;2;0;13;0;20;40
"210880 Pirapemas";2;3;0;15;0;20;40
"210890 Poção de Pedras";0;3;0;12;0;11;26
"210900 Porto Franco";5;1;0;21;0;19;46
"210905 Porto Rico do Maranhão";1;0;0;3;0;4;8
"210910 Presidente Dutra";11;1;1;29;0;23;65
"210920 Presidente Juscelino";0;0;0;5;0;5;10
"210923 Presidente Médici";1;0;0;4;0;2;7
"210927 Presidente Sarney";0;0;0;7;0;4;11
"210930 Presidente Vargas";0;0;0;5;0;4;9
"210940 Primeira Cruz";0;0;0;6;0;4;10
"210945 Raposa";15;5;0;68;0;54;142
"210950 Riachão";1;2;0;4;0;10;17
"210955 Ribamar Fiquene";2;0;0;3;0;4;9
"210960 Rosário";4;5;0;39;0;34;82
"210970 Sambaíba";1;0;0;0;0;0;1
"210975 Santa Filomena do Maranhão";0;0;0;0;0;1;1
"210980 Santa Helena";5;8;0;30;0;29;72
"210990 Santa Inês";23;11;0;38;0;83;155
"211000 Santa Luzia";9;6;0;54;0;48;117
"211003 Santa Luzia do Paruá";2;0;0;11;0;8;21
"211010 Santa Quitéria do Maranhão";3;1;0;12;0;10;26
"211020 Santa Rita";2;5;0;18;0;15;40
"211023 Santana do Maranhão";0;0;0;1;0;2;3
"211027 Santo Amaro do Maranhão";1;0;0;3;0;3;7
"211030 Santo Antônio dos Lopes";0;1;0;8;0;6;15
"211040 São Benedito do Rio Preto";1;0;0;3;0;8;12
"211050 São Bento";1;4;0;17;0;23;45
"211060 São Bernardo";3;1;0;12;0;22;38
"211065 São Domingos do Azeitão";0;0;0;2;0;0;2
"211070 São Domingos do Maranhão";4;1;0;18;0;16;39
"211080 São Félix de Balsas";1;0;0;1;0;0;2
"211085 São Francisco do Brejão";0;0;0;2;0;6;8
"211090 São Francisco do Maranhão";0;2;0;2;0;2;6
"211100 São João Batista";3;1;0;5;0;7;16
"211102 São João do Carú";2;0;0;2;0;3;7
"211105 São João do Paraíso";1;0;0;0;0;1;2
"211107 São João do Soter";0;1;0;5;0;2;8
"211110 São João dos Patos";3;2;0;13;0;15;33
"211120 São José de Ribamar";48;35;4;236;0;232;555
"211125 São José dos Basílios";2;0;0;2;0;2;6
"211130 São Luís";491;430;7;2481;8;3010;6427
"211140 São Luís Gonzaga do Maranhão";4;3;0;12;0;17;36
"211150 São Mateus do Maranhão";8;10;0;61;0;60;139
"211153 São Pedro da Água Branca";1;1;0;9;0;10;21
"211157 São Pedro dos Crentes";0;0;0;0;0;1;1
"211160 São Raimundo das Mangabeiras";2;2;0;7;0;4;15
"211163 São Raimundo do Doca Bezerra";0;0;0;1;0;0;1
"211167 São Roberto";0;1;0;1;0;2;4
"211170 São Vicente Ferrer";0;2;0;4;0;1;7
"211172 Satubinha";0;0;0;1;0;3;4
"211174 Senador Alexandre Costa";0;3;0;2;0;11;16
"211176 Senador La Rocque";1;2;0;5;0;3;11
"211178 Serrano do Maranhão";0;1;0;1;0;3;5
"211180 Sítio Novo";2;0;0;4;0;3;9
"211190 Sucupira do Norte";0;0;0;2;0;7;9
"211200 Tasso Fragoso";0;0;0;3;0;2;5
"211210 Timbiras";2;2;0;10;0;10;24
"211220 Timon";31;36;0;210;0;234;511
"211223 Trizidela do Vale";3;5;0;30;0;15;53
"211227 Tufilândia";0;0;0;2;0;5;7
"211230 Tuntum";0;3;1;5;0;9;18
"211240 Turiaçu";1;2;0;19;0;16;38
"211245 Turilândia";2;1;0;4;0;7;14
"211250 Tutóia";2;0;0;16;0;13;31
"211260 Urbano Santos";1;0;0;11;0;11;23
"211270 Vargem Grande";1;0;0;12;0;15;28
"211280 Viana";2;4;0;33;0;36;75
"211285 Vila Nova dos Martírios";1;1;0;2;0;6;10
"211290 Vitória do Mearim";3;2;0;25;0;33;63
"211300 Vitorino Freire";11;1;1;20;0;22;55
"211400 Zé Doca";7;2;0;30;0;29;68
"210000 Município ignorado - MA";0;0;0;2;0;1;3
"220010 Agricolândia";0;0;0;2;0;2;4
"220020 Água Branca";1;1;0;9;0;8;19
"220025 Alagoinha do Piauí";0;0;0;2;0;3;5
"220027 Alegrete do Piauí";0;0;0;1;0;4;5
"220030 Alto Longá";2;0;1;9;0;6;18
"220040 Altos";11;3;0;63;0;37;114
"220045 Alvorada do Gurguéia";0;0;0;2;0;1;3
"220050 Amarante";1;7;0;9;0;8;25
"220060 Angical do Piauí";0;1;0;5;0;4;10
"220070 Anísio de Abreu";0;0;0;0;0;4;4
"220090 Aroazes";0;1;0;1;0;0;2
"220100 Arraial";0;0;0;6;0;8;14
"220110 Avelino Lopes";0;0;0;3;0;0;3
"220115 Baixa Grande do Ribeiro";0;0;0;1;0;0;1
"220117 Barra D'Alcântara";0;0;0;1;0;5;6
"220120 Barras";2;3;0;18;0;14;37
"220140 Barro Duro";1;1;0;11;0;3;16
"220150 Batalha";1;1;0;11;0;5;18
"220157 Belém do Piauí";0;0;0;0;0;1;1
"220160 Beneditinos";1;0;0;4;0;5;10
"220170 Bertolínia";0;1;0;4;0;4;9
"220177 Boa Hora";0;0;0;2;0;4;6
"220180 Bocaina";1;0;0;0;0;7;8
"220190 Bom Jesus";5;1;0;8;0;5;19
"220191 Bom Princípio do Piauí";0;0;0;0;0;1;1
"220192 Bonfim do Piauí";0;0;0;2;0;2;4
"220194 Boqueirão do Piauí";1;0;0;1;0;0;2
"220196 Brasileira";0;2;0;1;0;7;10
"220200 Buriti dos Lopes";0;0;0;7;0;7;14
"220202 Buriti dos Montes";0;0;0;1;0;1;2
"220205 Cabeceiras do Piauí";2;0;0;2;0;3;7
"220207 Cajazeiras do Piauí";0;1;0;2;0;1;4
"220208 Cajueiro da Praia";0;0;0;3;0;6;9
"220209 Caldeirão Grande do Piauí";0;0;0;0;0;2;2
"220210 Campinas do Piauí";0;0;0;2;0;0;2
"220211 Campo Alegre do Fidalgo";0;2;0;0;0;0;2
"220213 Campo Grande do Piauí";1;0;0;1;0;2;4
"220220 Campo Maior";8;8;0;61;0;61;138
"220225 Canavieira";0;0;0;1;0;1;2
"220230 Canto do Buriti";1;2;1;8;0;6;18
"220240 Capitão de Campos";0;0;0;3;0;3;6
"220250 Caracol";1;0;0;1;0;0;2
"220253 Caraúbas do Piauí";0;0;0;1;0;0;1
"220255 Caridade do Piauí";0;1;0;2;0;2;5
"220260 Castelo do Piauí";1;0;0;8;0;3;12
"220270 Cocal";1;0;0;4;0;5;10
"220271 Cocal de Telha";0;1;0;8;0;0;9
"220272 Cocal dos Alves";0;0;0;1;0;0;1
"220273 Coivaras";0;0;0;3;0;0;3
"220277 Colônia do Piauí";0;2;0;3;0;5;10
"220285 Coronel José Dias";0;0;0;0;0;1;1
"220290 Corrente";2;0;0;3;0;3;8
"220310 Cristino Castro";1;0;0;5;0;2;8
"220320 Curimatá";0;1;0;2;0;0;3
"220325 Curralinhos";0;1;0;0;0;0;1
"220330 Demerval Lobão";2;3;0;20;0;8;33
"220335 Dirceu Arcoverde";1;0;0;1;0;0;2
"220340 Dom Expedito Lopes";2;1;0;6;0;4;13
"220345 Dom Inocêncio";0;0;0;1;0;1;2
"220350 Elesbão Veloso";2;0;1;7;0;6;16
"220360 Eliseu Martins";1;0;0;0;0;3;4
"220370 Esperantina";3;5;0;28;0;24;60
"220375 Fartura do Piauí";0;0;0;1;0;0;1
"220380 Flores do Piauí";0;0;0;1;0;2;3
"220385 Floresta do Piauí";0;0;0;0;0;1;1
"220390 Floriano";2;12;0;36;0;72;122
"220400 Francinópolis";1;2;0;6;0;1;10
"220410 Francisco Ayres";0;1;0;0;0;4;5
"220420 Francisco Santos";2;0;0;2;0;7;11
"220430 Fronteiras";0;0;0;3;0;3;6
"220435 Geminiano";1;0;0;3;0;3;7
"220440 Gilbués";0;0;0;2;0;0;2
"220450 Guadalupe";7;2;0;27;0;18;54
"220455 Guaribas";0;0;0;1;0;0;1
"220460 Hugo Napoleão";2;0;0;3;0;2;7
"220465 Ilha Grande";3;2;0;10;0;6;21
"220470 Inhuma";1;2;0;7;0;8;18
"220480 Ipiranga do Piauí";0;3;0;3;0;2;8
"220490 Isaías Coelho";0;0;0;1;0;0;1
"220500 Itainópolis";0;0;0;2;0;2;4
"220510 Itaueira";0;0;0;1;0;3;4
"220520 Jaicós";0;1;0;6;0;5;12
"220525 Jardim do Mulato";0;0;0;1;0;1;2
"220527 Jatobá do Piauí";0;0;0;1;0;0;1
"220535 João Costa";0;0;0;1;0;0;1
"220540 Joaquim Pires";0;0;0;4;0;0;4
"220545 Joca Marques";1;0;0;2;0;3;6
"220550 José de Freitas";5;1;0;15;0;5;26
"220551 Juazeiro do Piauí";0;0;0;2;0;1;3
"220553 Jurema";0;0;0;1;0;0;1
"220555 Lagoa Alegre";0;0;0;1;0;1;2
"220557 Lagoa de São Francisco";0;0;0;1;0;0;1
"220559 Lagoa do Sítio";0;0;0;1;0;1;2
"220554 Lagoinha do Piauí";0;1;0;0;0;0;1
"220560 Landri Sales";0;2;0;1;0;3;6
"220570 Luís Correia";2;0;0;7;0;7;16
"220580 Luzilândia";5;2;0;29;0;15;51
"220585 Madeiro";0;0;0;0;0;2;2
"220590 Manoel Emídio";0;0;0;1;0;1;2
"220595 Marcolândia";0;0;0;3;0;1;4
"220600 Marcos Parente";0;1;0;0;0;3;4
"220605 Massapê do Piauí";0;2;0;3;0;4;9
"220610 Matias Olímpio";0;0;0;9;0;5;14
"220620 Miguel Alves";3;7;0;10;0;9;29
"220630 Miguel Leão";0;0;0;0;0;1;1
"220640 Monsenhor Gil";1;1;0;7;0;3;12
"220660 Monte Alegre do Piauí";0;1;0;1;0;2;4
"220665 Morro Cabeça no Tempo";0;0;0;1;0;0;1
"220667 Morro do Chapéu do Piauí";1;0;0;0;0;0;1
"220669 Murici dos Portelas";1;0;0;0;0;1;2
"220670 Nazaré do Piauí";0;1;0;2;0;6;9
"220675 Nossa Senhora de Nazaré";0;0;0;1;0;1;2
"220680 Nossa Senhora dos Remédios";1;1;0;2;0;2;6
"220690 Novo Oriente do Piauí";1;0;0;1;0;2;4
"220695 Novo Santo Antônio";0;0;0;0;0;1;1
"220700 Oeiras";8;10;0;49;0;52;119
"220710 Olho D'Água do Piauí";0;0;0;1;0;0;1
"220720 Padre Marcos";0;0;0;1;0;0;1
"220730 Paes Landim";1;0;0;0;0;0;1
"220740 Palmeira do Piauí";0;0;0;1;0;0;1
"220750 Palmeirais";0;0;0;7;0;1;8
"220755 Paquetá";1;0;0;1;0;2;4
"220760 Parnaguá";0;0;0;1;0;0;1
"220770 Parnaíba";27;7;1;127;0;160;322
"220775 Passagem Franca do Piauí";0;0;0;3;0;3;6
"220777 Patos do Piauí";0;0;0;1;0;2;3
"220780 Paulistana";1;1;0;1;0;2;5
"220790 Pedro II";4;0;0;21;0;20;45
"220800 Picos";9;0;0;30;0;44;83
"220810 Pimenteiras";0;0;0;1;0;2;3
"220820 Pio IX";1;0;0;1;0;6;8
"220830 Piracuruca";1;2;1;14;0;12;30
"220840 Piripiri";17;4;0;49;0;36;106
"220850 Porto";0;0;0;5;0;2;7
"220855 Porto Alegre do Piauí";0;0;0;1;0;0;1
"220860 Prata do Piauí";0;0;0;2;0;0;2
"220865 Queimada Nova";0;0;0;2;0;0;2
"220870 Redenção do Gurguéia";0;0;0;1;0;2;3
"220880 Regeneração";1;1;0;4;0;3;9
"220887 Ribeira do Piauí";0;0;0;0;0;1;1
"220890 Ribeiro Gonçalves";0;0;0;1;0;0;1
"220900 Rio Grande do Piauí";0;0;0;5;0;3;8
"220910 Santa Cruz do Piauí";0;1;0;2;0;1;4
"220915 Santa Cruz dos Milagres";0;0;0;2;0;0;2
"220920 Santa Filomena";0;0;0;0;0;1;1
"220930 Santa Luz";0;1;0;0;0;2;3
"220937 Santa Rosa do Piauí";0;0;0;3;0;1;4
"220940 Santo Antônio de Lisboa";3;0;0;2;0;13;18
"220950 Santo Inácio do Piauí";0;0;1;2;0;4;7
"220955 São Braz do Piauí";0;0;0;2;0;1;3
"220960 São Félix do Piauí";2;0;0;2;0;0;4
"220970 São Francisco do Piauí";0;0;0;0;0;2;2
"220980 São Gonçalo do Piauí";0;0;0;1;0;0;1
"220985 São João da Canabrava";0;0;0;0;0;4;4
"220987 São João da Fronteira";1;0;0;2;0;0;3
"220990 São João da Serra";0;0;0;2;0;3;5
"220995 São João da Varjota";0;0;0;4;0;3;7
"220997 São João do Arraial";0;0;0;5;0;3;8
"221000 São João do Piauí";2;0;0;8;0;7;17
"221005 São José do Divino";0;0;0;0;0;1;1
"221010 São José do Peixe";0;0;0;1;0;2;3
"221020 São José do Piauí";0;0;0;0;0;4;4
"221030 São Julião";0;0;0;1;0;2;3
"221035 São Lourenço do Piauí";0;0;0;1;0;0;1
"221037 São Luis do Piauí";0;0;0;1;0;2;3
"221038 São Miguel da Baixa Grande";0;0;0;5;0;2;7
"221040 São Miguel do Tapuio";2;0;0;9;0;9;20
"221050 São Pedro do Piauí";1;0;0;2;0;3;6
"221060 São Raimundo Nonato";3;1;0;21;0;23;48
"221063 Sebastião Leal";1;0;0;0;0;1;2
"221065 Sigefredo Pacheco";0;0;0;2;0;2;4
"221070 Simões";0;0;0;0;0;6;6
"221080 Simplício Mendes";1;3;0;4;0;8;16
"221090 Socorro do Piauí";0;0;0;0;0;1;1
"221093 Sussuapara";0;0;0;1;0;1;2
"221095 Tamboril do Piauí";0;0;0;1;0;0;1
"221097 Tanque do Piauí";2;0;0;2;0;0;4
"221100 Teresina";417;218;6;1770;1;1300;3712
"221110 União";1;0;0;32;0;18;51
"221120 Uruçuí";2;1;0;15;0;14;32
"221130 Valença do Piauí";1;1;0;12;0;20;34
"221135 Várzea Branca";0;0;0;1;0;0;1
"221140 Várzea Grande";1;0;0;2;0;4;7
"221150 Vera Mendes";1;0;0;0;0;2;3
"221170 Wall Ferraz";0;0;0;4;0;1;5
"220000 Município ignorado - PI";0;0;0;0;0;2;2
"230010 Abaiara";0;0;0;0;0;4;4
"230015 Acarape";0;0;0;8;0;5;13
"230020 Acaraú";6;5;0;44;0;28;83
"230030 Acopiara";2;1;0;10;0;12;25
"230040 Aiuaba";0;0;0;3;0;3;6
"230050 Alcântaras";0;1;0;5;0;6;12
"230060 Altaneira";0;0;0;1;0;2;3
"230070 Alto Santo";1;0;0;6;0;5;12
"230075 Amontada";0;0;0;7;1;11;19
"230080 Antonina do Norte";0;0;0;1;0;5;6
"230090 Apuiarés";2;0;0;3;0;2;7
"230100 Aquiraz";3;1;2;57;0;45;108
"230110 Aracati";7;8;0;103;0;86;204
"230120 Aracoiaba";0;0;0;14;0;4;18
"230125 Ararendá";0;0;0;2;0;1;3
"230130 Araripe";0;0;0;3;0;10;13
"230140 Aratuba";0;0;0;2;0;3;5
"230150 Arneiroz";0;0;0;1;0;3;4
"230160 Assaré";2;0;0;4;0;4;10
"230170 Aurora";3;1;0;4;0;12;20
"230180 Baixio";0;0;0;0;0;1;1
"230185 Banabuiú";0;1;0;9;0;0;10
"230190 Barbalha";1;1;0;8;0;35;45
"230195 Barreira";0;0;0;6;0;13;19
"230200 Barro";2;0;0;1;0;9;12
"230205 Barroquinha";1;0;0;2;0;4;7
"230210 Baturité";1;1;2;15;0;13;32
"230220 Beberibe";4;1;0;62;0;44;111
"230230 Bela Cruz";0;0;0;13;0;4;17
"230240 Boa Viagem";2;0;0;17;0;14;33
"230250 Brejo Santo";1;1;1;11;0;22;36
"230260 Camocim";7;2;0;29;0;26;64
"230270 Campos Sales";1;0;0;1;0;14;16
"230280 Canindé";6;2;0;70;0;57;135
"230290 Capistrano";1;0;0;6;0;6;13
"230300 Caridade";0;0;0;7;0;7;14
"230310 Cariré";1;0;0;10;0;10;21
"230320 Caririaçu";3;1;0;6;0;13;23
"230330 Cariús";0;0;0;4;0;4;8
"230340 Carnaubal";5;0;0;5;0;16;26
"230350 Cascavel";10;4;0;76;0;59;149
"230360 Catarina";0;0;0;2;0;2;4
"230365 Catunda";0;1;0;2;0;3;6
"230370 Caucaia";49;12;3;353;0;349;766
"230380 Cedro";0;0;1;14;0;8;23
"230390 Chaval";2;0;0;2;0;3;7
"230393 Choró";0;0;0;0;0;1;1
"230395 Chorozinho";2;1;0;22;0;15;40
"230400 Coreaú";1;0;0;4;0;10;15
"230410 Crateús";4;3;1;41;0;54;103
"230420 Crato";10;1;0;23;0;99;133
"230423 Croatá";2;2;0;17;0;16;37
"230425 Cruz";2;1;0;17;0;15;35
"230426 Deputado Irapuan Pinheiro";0;0;0;1;0;0;1
"230427 Ererê";0;0;0;1;0;1;2
"230428 Eusébio";3;1;0;48;0;28;80
"230430 Farias Brito";1;0;0;2;0;7;10
"230435 Forquilha";4;2;0;12;0;10;28
"230440 Fortaleza";577;165;45;4866;17;5939;11609
"230445 Fortim";0;1;0;9;0;13;23
"230450 Frecheirinha";7;0;0;11;0;10;28
"230460 General Sampaio";1;0;0;6;0;0;7
"230465 Graça";5;0;0;6;0;13;24
"230470 Granja";7;0;0;12;0;8;27
"230480 Granjeiro";0;0;0;1;0;1;2
"230490 Groaíras";3;1;0;14;0;15;33
"230495 Guaiúba";0;1;0;13;0;12;26
"230500 Guaraciaba do Norte";9;3;0;25;0;44;81
"230510 Guaramiranga";1;0;0;6;0;4;11
"230520 Hidrolândia";0;1;0;13;0;21;35
"230523 Horizonte";8;1;0;80;0;42;131
"230526 Ibaretama";0;0;0;9;0;6;15
"230530 Ibiapina";5;0;0;9;0;13;27
"230533 Ibicuitinga";1;0;0;3;0;6;10
"230535 Icapuí";2;1;0;11;0;7;21
"230540 Icó";1;0;1;21;0;24;47
"230550 Iguatu";9;2;0;125;0;91;227
"230560 Independência";1;0;0;7;0;7;15
"230565 Ipaporanga";1;0;0;3;0;5;9
"230570 Ipaumirim";0;0;0;3;0;5;8
"230580 Ipu";6;1;1;22;0;34;64
"230590 Ipueiras";3;3;0;14;0;24;44
"230600 Iracema";1;0;0;2;0;2;5
"230610 Irauçuba";0;0;0;7;0;4;11
"230620 Itaiçaba";1;0;0;6;0;3;10
"230625 Itaitinga";4;2;1;57;0;51;115
"230630 Itapagé";0;0;0;11;0;10;21
"230640 Itapipoca";2;0;0;65;0;35;102
"230650 Itapiúna";0;0;0;3;0;1;4
"230655 Itarema";2;1;1;14;0;9;27
"230660 Itatira";1;1;0;4;0;4;10
"230670 Jaguaretama";0;0;0;3;0;3;6
"230680 Jaguaribara";0;0;0;2;0;2;4
"230690 Jaguaribe";6;0;0;51;0;40;97
"230700 Jaguaruana";0;0;0;13;0;9;22
"230710 Jardim";0;0;0;0;0;8;8
"230720 Jati";0;1;0;2;0;4;7
"230725 Jijoca de Jericoacoara";5;0;0;24;0;18;47
"230730 Juazeiro do Norte";10;9;1;51;0;279;350
"230740 Jucás";1;0;0;10;0;8;19
"230750 Lavras da Mangabeira";0;0;0;3;0;11;14
"230760 Limoeiro do Norte";5;0;1;34;0;22;62
"230763 Madalena";1;0;0;3;0;7;11
"230765 Maracanaú";47;13;2;315;5;330;712
"230770 Maranguape";2;2;1;52;0;52;109
"230780 Marco";2;0;0;5;0;7;14
"230790 Martinópole";0;0;0;2;0;0;2
"230800 Massapê";0;1;0;13;0;9;23
"230810 Mauriti";2;1;0;3;0;14;20
"230820 Meruoca";0;1;0;4;0;5;10
"230830 Milagres";1;0;0;3;0;5;9
"230835 Milhã";0;0;0;8;0;1;9
"230837 Miraíma";0;0;0;1;0;5;6
"230840 Missão Velha";1;0;0;5;0;12;18
"230850 Mombaça";2;1;0;16;0;18;37
"230860 Monsenhor Tabosa";2;0;0;11;0;7;20
"230870 Morada Nova";2;1;0;34;0;23;60
"230880 Moraújo";0;0;0;2;0;3;5
"230890 Morrinhos";0;0;0;3;0;5;8
"230900 Mucambo";4;0;0;9;0;17;30
"230910 Mulungu";2;0;0;4;0;1;7
"230920 Nova Olinda";1;0;0;0;0;4;5
"230930 Nova Russas";3;0;0;14;0;21;38
"230940 Novo Oriente";0;2;0;5;0;13;20
"230945 Ocara";0;1;0;10;0;9;20
"230950 Orós";0;1;0;13;0;11;25
"230960 Pacajus";7;3;2;78;0;47;137
"230970 Pacatuba";2;1;0;42;2;45;92
"230980 Pacoti";0;0;0;10;0;6;16
"230990 Pacujá";3;0;0;5;0;12;20
"231000 Palhano";0;0;0;4;0;4;8
"231010 Palmácia";0;0;0;2;0;4;6
"231020 Paracuru";4;1;0;38;0;27;70
"231025 Paraipaba";2;0;0;27;0;25;54
"231030 Parambu";0;0;0;15;0;11;26
"231040 Paramoti";1;0;0;5;0;2;8
"231050 Pedra Branca";2;2;0;13;0;16;33
"231060 Penaforte";1;1;0;2;0;7;11
"231070 Pentecoste";3;2;0;42;0;31;78
"231080 Pereiro";1;0;0;9;0;4;14
"231085 Pindoretama";1;0;0;25;0;16;42
"231090 Piquet Carneiro";0;0;0;3;0;3;6
"231095 Pires Ferreira";0;2;0;1;0;3;6
"231100 Poranga";0;1;0;4;0;1;6
"231110 Porteiras";0;0;0;3;0;1;4
"231120 Potengi";0;0;0;3;0;4;7
"231126 Quiterianópolis";1;0;0;4;0;4;9
"231130 Quixadá";7;1;0;60;0;52;120
"231135 Quixelô";1;0;0;2;0;0;3
"231140 Quixeramobim";1;0;0;18;0;16;35
"231150 Quixeré";0;1;0;8;0;5;14
"231160 Redenção";4;0;0;13;0;16;33
"231170 Reriutaba";4;2;0;12;0;22;40
"231180 Russas";6;5;0;82;0;72;165
"231190 Saboeiro";0;1;0;5;0;2;8
"231195 Salitre";0;1;0;0;0;3;4
"231220 Santa Quitéria";4;0;0;15;0;14;33
"231200 Santana do Acaraú";1;2;0;8;0;9;20
"231210 Santana do Cariri";0;0;0;0;0;1;1
"231230 São Benedito";7;5;0;23;0;45;80
"231240 São Gonçalo do Amarante";2;2;0;39;0;17;60
"231250 São João do Jaguaribe";0;0;0;3;0;1;4
"231260 São Luís do Curu";1;1;0;15;0;6;23
"231270 Senador Pompeu";0;1;0;8;0;3;12
"231280 Senador Sá";0;0;0;1;0;3;4
"231290 Sobral";47;39;1;203;0;175;465
"231300 Solonópole";1;1;0;8;0;11;21
"231310 Tabuleiro do Norte";4;0;0;35;0;29;68
"231320 Tamboril";2;0;0;6;0;9;17
"231325 Tarrafas";0;0;0;0;0;2;2
"231330 Tauá";4;0;1;38;0;32;75
"231335 Tejuçuoca";0;0;0;5;0;2;7
"231340 Tianguá";8;2;0;34;0;19;63
"231350 Trairi";1;2;0;25;1;23;52
"231355 Tururu";0;0;0;7;0;3;10
"231360 Ubajara";2;0;0;12;0;14;28
"231370 Umari";0;0;0;0;0;2;2
"231375 Umirim";0;0;0;9;0;2;11
"231380 Uruburetama";0;0;0;12;0;3;15
"231390 Uruoca";1;0;0;6;0;2;9
"231395 Varjota";5;0;0;11;0;14;30
"231400 Várzea Alegre";1;1;0;3;0;9;14
"231410 Viçosa do Ceará";4;2;0;20;0;9;35
"230000 Município ignorado - CE";0;1;0;0;0;1;2
"240010 Acari";1;1;0;4;0;14;20
"240020 Açu";14;1;0;30;0;20;65
"240030 Afonso Bezerra";0;0;0;1;0;0;1
"240050 Alexandria";2;0;0;3;0;5;10
"240060 Almino Afonso";6;0;0;0;0;1;7
"240070 Alto do Rodrigues";4;0;0;3;0;10;17
"240080 Angicos";1;0;0;13;0;11;25
"240090 Antônio Martins";1;0;0;2;0;3;6
"240100 Apodi";7;2;0;17;0;7;33
"240110 Areia Branca";17;8;0;33;0;32;90
"240120 Arês";1;0;0;4;0;2;7
"240130 Augusto Severo";0;1;0;2;0;0;3
"240140 Baía Formosa";0;0;0;3;0;8;11
"240145 Baraúna";11;2;0;16;0;10;39
"240150 Barcelona";0;0;0;1;0;2;3
"240160 Bento Fernandes";0;0;0;1;0;3;4
"240165 Bodó";0;0;0;2;0;1;3
"240170 Bom Jesus";2;0;0;2;0;8;12
"240180 Brejinho";0;0;0;2;0;4;6
"240185 Caiçara do Norte";0;0;0;0;0;2;2
"240190 Caiçara do Rio do Vento";1;0;0;0;0;2;3
"240200 Caicó";8;2;0;17;0;32;59
"240210 Campo Redondo";0;0;0;3;0;1;4
"240220 Canguaretama";4;2;1;12;0;38;57
"240230 Caraúbas";1;1;0;13;0;5;20
"240240 Carnaúba dos Dantas";0;0;0;0;0;1;1
"240250 Carnaubais";2;0;0;2;0;1;5
"240260 Ceará-Mirim";18;3;0;42;0;48;111
"240270 Cerro Corá";0;0;0;2;0;1;3
"240280 Coronel Ezequiel";0;1;0;2;0;0;3
"240290 Coronel João Pessoa";3;0;0;0;0;0;3
"240300 Cruzeta";1;0;0;1;0;4;6
"240310 Currais Novos";8;0;0;11;0;23;42
"240320 Doutor Severiano";0;0;0;2;0;1;3
"240330 Encanto";0;0;0;3;0;2;5
"240340 Equador";0;0;0;1;0;0;1
"240350 Espírito Santo";0;0;0;2;0;3;5
"240360 Extremoz";3;0;0;27;0;51;81
"240370 Felipe Guerra";0;1;0;0;0;0;1
"240375 Fernando Pedroza";0;1;0;0;0;1;2
"240380 Florânia";0;0;0;3;0;2;5
"240390 Francisco Dantas";0;0;0;1;0;1;2
"240400 Frutuoso Gomes";4;0;0;7;0;4;15
"240410 Galinhos";0;0;0;1;0;2;3
"240420 Goianinha";4;0;0;15;0;20;39
"240430 Governador Dix-Sept Rosado";6;3;0;5;0;4;18
"240440 Grossos";3;5;0;3;0;4;15
"240450 Guamaré";2;2;0;9;0;11;24
"240460 Ielmo Marinho";0;0;0;2;0;0;2
"240470 Ipanguaçu";2;0;0;11;0;3;16
"240480 Ipueira";0;0;0;0;0;2;2
"240485 Itajá";2;1;0;4;0;4;11
"240490 Itaú";0;0;0;2;0;8;10
"240500 Jaçanã";0;0;0;2;0;4;6
"240510 Jandaíra";1;0;0;1;0;8;10
"240520 Janduís";1;0;0;1;0;0;2
"240530 Januário Cicco";0;0;0;3;0;1;4
"240540 Japi";4;0;0;0;0;3;7
"240560 Jardim de Piranhas";4;1;0;7;0;8;20
"240570 Jardim do Seridó";1;0;0;1;0;3;5
"240580 João Câmara";3;0;0;16;0;20;39
"240590 João Dias";0;0;0;1;0;0;1
"240600 José da Penha";0;0;0;1;0;1;2
"240610 Jucurutu";2;0;0;1;0;7;10
"240620 Lagoa d'Anta";0;0;0;1;0;1;2
"240630 Lagoa de Pedras";0;0;0;4;0;3;7
"240650 Lagoa Nova";1;0;0;1;0;2;4
"240660 Lagoa Salgada";1;0;0;7;0;4;12
"240670 Lajes";2;0;0;6;0;6;14
"240680 Lajes Pintadas";0;0;0;2;0;5;7
"240690 Lucrécia";0;0;0;1;0;2;3
"240700 Luís Gomes";0;0;0;0;0;1;1
"240710 Macaíba";15;8;0;49;0;57;129
"240720 Macau";7;4;0;41;0;39;91
"240725 Major Sales";0;1;0;1;0;1;3
"240730 Marcelino Vieira";0;0;0;0;0;1;1
"240740 Martins";0;1;0;7;0;8;16
"240750 Maxaranguape";0;1;1;1;0;1;4
"240760 Messias Targino";2;0;0;1;0;1;4
"240770 Montanhas";2;0;1;4;0;6;13
"240780 Monte Alegre";0;1;0;4;0;8;13
"240800 Mossoró";181;30;1;238;1;224;675
"240810 Natal";354;85;8;910;2;1644;3003
"240820 Nísia Floresta";2;4;0;6;0;20;32
"240830 Nova Cruz";6;0;1;18;0;21;46
"240840 Olho-d'Água do Borges";0;0;0;2;0;1;3
"240850 Ouro Branco";0;0;0;2;0;0;2
"240860 Paraná";1;0;0;0;0;2;3
"240870 Paraú";2;1;0;0;0;0;3
"240880 Parazinho";1;0;0;5;0;4;10
"240890 Parelhas";3;0;0;8;0;17;28
"240325 Parnamirim";74;10;0;195;1;190;470
"240910 Passa e Fica";1;0;0;4;0;8;13
"240920 Passagem";1;0;0;2;0;1;4
"240930 Patu";11;1;0;11;0;13;36
"240940 Pau dos Ferros";6;2;0;15;0;29;52
"240950 Pedra Grande";0;0;0;1;0;2;3
"240960 Pedra Preta";0;0;0;1;0;0;1
"240970 Pedro Avelino";1;1;0;3;0;0;5
"240980 Pedro Velho";1;0;0;5;0;18;24
"240990 Pendências";0;1;0;10;0;6;17
"241010 Poço Branco";1;0;0;1;0;4;6
"241020 Portalegre";0;1;0;4;0;7;12
"241030 Presidente Juscelino";2;0;0;8;0;13;23
"241040 Pureza";2;0;0;1;0;2;5
"241050 Rafael Fernandes";1;0;0;3;0;6;10
"241070 Riacho da Cruz";0;0;0;0;0;1;1
"241080 Riacho de Santana";0;0;0;0;0;2;2
"241090 Riachuelo";0;0;0;1;0;1;2
"240895 Rio do Fogo";0;0;0;5;0;3;8
"241100 Rodolfo Fernandes";1;0;0;8;0;4;13
"241110 Ruy Barbosa";0;0;0;0;0;2;2
"241120 Santa Cruz";6;0;0;19;0;30;55
"240933 Santa Maria";2;0;0;5;0;3;10
"241140 Santana do Matos";2;0;0;1;0;4;7
"241150 Santo Antônio";4;1;0;13;0;12;30
"241170 São Bento do Trairí";0;0;0;0;0;2;2
"241180 São Fernando";0;0;0;0;0;1;1
"241190 São Francisco do Oeste";4;1;0;2;0;7;14
"241200 São Gonçalo do Amarante";22;6;0;62;0;71;161
"241210 São João do Sabugi";0;0;0;1;0;3;4
"241220 São José de Mipibu";3;0;1;13;0;29;46
"241230 São José do Campestre";2;0;0;7;0;8;17
"241240 São José do Seridó";0;0;0;1;0;2;3
"241250 São Miguel";4;1;0;5;0;7;17
"241255 São Miguel do Gostoso";0;0;0;2;0;0;2
"241260 São Paulo do Potengi";0;1;0;11;0;11;23
"241270 São Pedro";1;0;0;1;0;1;3
"241280 São Rafael";1;1;0;11;0;8;21
"241290 São Tomé";0;1;0;0;0;2;3
"241300 São Vicente";0;1;0;0;0;1;2
"241310 Senador Elói de Souza";0;0;0;2;0;1;3
"241320 Senador Georgino Avelino";1;0;0;2;0;5;8
"241330 Serra de São Bento";2;1;0;3;0;3;9
"241335 Serra do Mel";7;2;0;5;0;3;17
"241340 Serra Negra do Norte";1;0;0;1;0;2;4
"241350 Serrinha";1;0;0;1;0;2;4
"241355 Serrinha dos Pintos";1;0;0;2;0;2;5
"241360 Severiano Melo";1;0;0;0;0;1;2
"241370 Sítio Novo";0;0;0;0;0;3;3
"241380 Taboleiro Grande";0;0;0;1;0;0;1
"241390 Taipu";1;0;0;6;0;10;17
"241400 Tangará";2;0;0;9;0;12;23
"241410 Tenente Ananias";0;0;0;1;0;1;2
"241415 Tenente Laurentino Cruz";0;0;0;0;0;1;1
"241105 Tibau";0;0;0;1;0;1;2
"241420 Tibau do Sul";3;2;0;2;0;10;17
"241440 Touros";4;0;0;11;0;17;32
"241445 Triunfo Potiguar";0;0;0;1;0;1;2
"241450 Umarizal";1;1;0;4;0;4;10
"241470 Várzea";0;0;0;2;0;6;8
"241475 Venha-Ver";0;0;0;1;0;0;1
"241480 Vera Cruz";1;0;0;8;0;5;14
"241490 Viçosa";0;0;0;1;0;1;2
"241500 Vila Flor";0;0;0;1;0;1;2
"240000 Município ignorado - RN";0;0;0;0;0;1;1
"250010 Água Branca";0;0;0;2;0;2;4
"250020 Aguiar";0;0;0;0;0;2;2
"250030 Alagoa Grande";2;1;1;29;0;38;71
"250040 Alagoa Nova";1;2;0;3;0;16;22
"250050 Alagoinha";1;0;0;3;0;8;12
"250053 Alcantil";0;0;0;2;0;1;3
"250057 Algodão de Jandaíra";0;0;0;2;0;1;3
"250060 Alhandra";8;5;0;26;0;22;61
"250077 Aparecida";0;0;0;0;0;1;1
"250080 Araçagi";4;1;0;15;0;8;28
"250090 Arara";1;0;0;3;0;12;16
"250100 Araruna";3;1;0;8;0;9;21
"250110 Areia";2;0;0;8;0;14;24
"250120 Areial";0;0;0;2;0;2;4
"250130 Aroeiras";3;1;0;3;0;6;13
"250140 Baía da Traição";0;0;0;10;15;10;35
"250150 Bananeiras";0;0;0;7;0;13;20
"250153 Baraúna";0;0;0;0;0;1;1
"250160 Barra de Santa Rosa";0;1;0;5;0;5;11
"250157 Barra de Santana";1;0;0;0;0;4;5
"250170 Barra de São Miguel";0;0;0;0;0;1;1
"250180 Bayeux";34;5;2;174;0;137;352
"250190 Belém";0;0;0;4;0;8;12
"250200 Belém do Brejo do Cruz";0;0;0;1;0;3;4
"250210 Boa Ventura";0;0;0;1;0;0;1
"250215 Boa Vista";0;0;0;5;0;5;10
"250220 Bom Jesus";1;1;0;2;0;2;6
"250230 Bom Sucesso";2;0;0;2;0;1;5
"250240 Bonito de Santa Fé";0;0;0;2;0;1;3
"250250 Boqueirão";5;0;0;3;0;16;24
"250270 Borborema";0;0;0;1;0;1;2
"250280 Brejo do Cruz";2;0;0;6;0;2;10
"250290 Brejo dos Santos";0;0;0;0;0;4;4
"250300 Caaporã";4;6;0;30;0;15;55
"250310 Cabaceiras";1;0;0;1;0;6;8
"250320 Cabedelo";24;9;2;101;1;113;250
"250330 Cachoeira dos Índios";0;0;0;6;0;1;7
"250350 Cacimba de Dentro";1;0;0;5;0;5;11
"250355 Cacimbas";0;0;0;0;0;3;3
"250360 Caiçara";0;1;0;1;0;2;4
"250370 Cajazeiras";14;2;0;44;0;27;87
"250380 Caldas Brandão";0;1;0;1;0;1;3
"250390 Camalaú";0;0;0;0;0;3;3
"250400 Campina Grande";136;44;2;194;0;642;1018
"251640 Campo de Santana";0;0;0;7;0;2;9
"250403 Capim";2;0;0;1;0;2;5
"250407 Caraúbas";1;0;0;0;0;0;1
"250415 Casserengue";1;0;0;1;0;2;4
"250420 Catingueira";0;0;0;1;0;1;2
"250430 Catolé do Rocha";4;0;0;7;0;9;20
"250435 Caturité";1;0;0;3;0;1;5
"250440 Conceição";1;0;0;4;0;7;12
"250450 Condado";0;0;0;2;0;5;7
"250460 Conde";5;2;0;40;0;14;61
"250480 Coremas";1;0;0;2;0;5;8
"250485 Coxixola";0;0;0;0;0;1;1
"250490 Cruz do Espírito Santo";3;2;0;13;0;7;25
"250500 Cubati";2;0;0;3;0;1;6
"250510 Cuité";2;0;0;6;0;7;15
"250523 Cuité de Mamanguape";1;0;0;2;0;2;5
"250520 Cuitegi";2;0;0;1;0;1;4
"250527 Curral de Cima";1;1;0;4;0;1;7
"250530 Curral Velho";0;1;0;1;0;0;2
"250540 Desterro";1;1;0;1;0;4;7
"250560 Diamante";0;0;0;1;0;0;1
"250570 Dona Inês";2;2;0;4;0;7;15
"250580 Duas Estradas";0;0;0;4;0;0;4
"250600 Esperança";4;0;0;13;0;21;38
"250610 Fagundes";0;0;0;9;0;22;31
"250620 Frei Martinho";0;0;0;1;0;0;1
"250625 Gado Bravo";2;0;0;1;0;0;3
"250630 Guarabira";20;2;0;49;0;43;114
"250640 Gurinhém";1;0;0;13;0;7;21
"250660 Ibiara";0;0;0;0;0;1;1
"250260 Igaracy";2;0;0;2;0;2;6
"250670 Imaculada";1;1;0;1;0;1;4
"250680 Ingá";1;1;0;5;0;13;20
"250690 Itabaiana";2;2;0;31;0;33;68
"250700 Itaporanga";2;0;0;5;0;6;13
"250710 Itapororoca";4;2;0;17;0;13;36
"250720 Itatuba";1;0;0;2;0;4;7
"250730 Jacaraú";2;0;0;8;0;5;15
"250740 Jericó";1;1;0;4;0;1;7
"250750 João Pessoa";442;49;9;1041;3;1064;2608
"250760 Juarez Távora";0;0;0;1;0;5;6
"250770 Juazeirinho";0;0;0;2;0;7;9
"250780 Junco do Seridó";0;0;0;5;0;2;7
"250790 Juripiranga";3;2;0;23;0;11;39
"250800 Juru";1;0;0;3;0;0;4
"250810 Lagoa";0;0;0;1;0;0;1
"250820 Lagoa de Dentro";3;0;0;3;0;3;9
"250830 Lagoa Seca";4;1;0;10;0;20;35
"250850 Livramento";0;0;0;1;0;3;4
"250855 Logradouro";0;0;0;0;0;1;1
"250860 Lucena";7;1;0;15;0;14;37
"250880 Malta";1;0;0;5;0;6;12
"250890 Mamanguape";18;2;1;72;0;50;143
"250900 Manaíra";0;0;0;1;0;1;2
"250905 Marcação";0;0;0;3;9;2;14
"250910 Mari";8;3;0;37;0;24;72
"250915 Marizópolis";3;0;0;1;0;6;10
"250920 Massaranduba";2;1;0;5;0;9;17
"250930 Mataraca";1;1;1;5;1;2;11
"250933 Matinhas";0;0;0;1;0;1;2
"250939 Maturéia";0;0;0;3;0;2;5
"250940 Mogeiro";1;1;0;2;0;3;7
"250950 Montadas";0;0;0;0;0;1;1
"250960 Monte Horebe";0;0;0;2;0;0;2
"250970 Monteiro";4;0;0;16;0;15;35
"250980 Mulungu";3;1;0;5;0;5;14
"250990 Natuba";0;0;0;4;0;1;5
"251000 Nazarezinho";0;0;0;4;0;3;7
"251010 Nova Floresta";2;0;0;0;0;3;5
"251020 Nova Olinda";0;0;0;2;0;1;3
"251030 Nova Palmeira";0;0;0;1;0;1;2
"251040 Olho d'Água";1;0;0;0;0;4;5
"251050 Olivedos";0;0;0;0;0;1;1
"251060 Ouro Velho";0;0;0;2;0;2;4
"251065 Parari";0;0;0;1;0;0;1
"251080 Patos";40;5;0;73;0;64;182
"251090 Paulista";1;0;0;4;0;0;5
"251100 Pedra Branca";0;0;0;1;0;1;2
"251110 Pedra Lavrada";1;0;0;2;0;0;3
"251120 Pedras de Fogo";12;4;0;42;0;29;87
"251272 Pedro Régis";1;0;0;0;0;1;2
"251130 Piancó";1;0;0;1;0;0;2
"251140 Picuí";4;0;0;7;0;6;17
"251150 Pilar";2;0;0;4;0;6;12
"251160 Pilões";2;0;0;2;0;3;7
"251170 Pilõezinhos";0;0;0;4;0;3;7
"251180 Pirpirituba";1;2;0;5;0;5;13
"251190 Pitimbu";6;2;0;32;0;17;57
"251200 Pocinhos";0;0;0;2;0;8;10
"251203 Poço Dantas";0;0;0;0;0;1;1
"251210 Pombal";8;1;0;9;0;16;34
"251220 Prata";0;0;0;1;0;0;1
"251230 Princesa Isabel";1;0;0;7;0;3;11
"251240 Puxinanã";2;0;0;1;0;6;9
"251250 Queimadas";7;1;2;14;0;36;60
"251260 Quixabá";1;0;0;0;0;0;1
"251270 Remígio";1;2;0;5;0;6;14
"251274 Riachão";0;0;0;0;0;3;3
"251275 Riachão do Bacamarte";0;0;0;1;0;2;3
"251276 Riachão do Poço";1;0;0;1;0;0;2
"251280 Riacho dos Cavalos";1;0;0;1;0;0;2
"251290 Rio Tinto";6;2;0;36;7;35;86
"251300 Salgadinho";1;0;0;0;0;2;3
"251310 Salgado de São Félix";2;0;0;6;0;2;10
"251315 Santa Cecília";1;0;0;0;0;3;4
"251320 Santa Cruz";2;0;0;0;0;3;5
"251330 Santa Helena";0;0;0;1;0;1;2
"251340 Santa Luzia";4;2;0;3;0;6;15
"251370 Santa Rita";39;5;3;196;1;141;385
"251380 Santa Teresinha";0;0;0;1;0;2;3
"251350 Santana de Mangueira";0;0;0;0;0;1;1
"251360 Santana dos Garrotes";0;0;0;0;0;1;1
"251385 Santo André";1;0;0;0;0;3;4
"251390 São Bento";6;0;0;7;0;16;29
"251394 São Domingos do Cariri";0;0;0;1;0;0;1
"251398 São Francisco";0;0;0;1;0;2;3
"251400 São João do Cariri";0;0;0;1;0;1;2
"250070 São João do Rio do Peixe";3;0;0;1;0;3;7
"251410 São João do Tigre";0;0;0;2;0;0;2
"251420 São José da Lagoa Tapada";0;0;0;1;0;1;2
"251450 São José de Piranhas";3;1;0;3;0;9;16
"251460 São José do Bonfim";1;0;0;0;0;2;3
"251470 São José do Sabugi";1;0;0;0;0;2;3
"251480 São José dos Cordeiros";0;0;0;1;0;1;2
"251445 São José dos Ramos";5;0;0;1;0;1;7
"251490 São Mamede";2;0;0;5;0;4;11
"251500 São Miguel de Taipu";0;0;0;4;0;3;7
"251510 São Sebastião de Lagoa de Roça";1;1;0;1;0;3;6
"251530 Sapé";12;4;0;56;0;38;110
"251540 Seridó";1;0;0;2;0;2;5
"251550 Serra Branca";2;0;0;5;0;5;12
"251560 Serra da Raiz";0;0;0;3;0;2;5
"251580 Serra Redonda";5;1;0;7;0;24;37
"251590 Serraria";0;1;0;1;0;2;4
"251593 Sertãozinho";1;0;0;4;0;1;6
"251597 Sobrado";1;0;0;1;0;1;3
"251600 Solânea";4;0;0;9;0;13;26
"251610 Soledade";4;0;0;5;0;11;20
"251615 Sossêgo";2;0;0;0;0;1;3
"251620 Sousa";10;2;0;38;0;38;88
"251630 Sumé";0;0;0;11;0;13;24
"251650 Taperoá";0;1;0;2;0;6;9
"251660 Tavares";1;0;0;5;0;1;7
"251670 Teixeira";1;0;0;3;0;5;9
"251675 Tenório";0;0;0;1;0;1;2
"251680 Triunfo";0;0;0;2;0;4;6
"251690 Uiraúna";2;0;0;7;0;4;13
"251700 Umbuzeiro";5;2;0;4;0;4;15
"251710 Várzea";0;0;0;1;0;1;2
"251720 Vieirópolis";0;0;0;2;0;2;4
"250550 Vista Serrana";0;0;0;0;0;1;1
"251740 Zabelê";1;0;0;0;0;0;1
"250000 Município ignorado - PB";0;0;0;0;0;2;2
"260005 Abreu e Lima";54;23;1;117;1;243;439
"260010 Afogados da Ingazeira";6;1;0;9;0;19;35
"260020 Afrânio";1;1;0;4;0;8;14
"260030 Agrestina";3;0;0;13;0;10;26
"260040 Água Preta";0;7;0;28;0;26;61
"260050 Águas Belas";2;1;0;10;5;16;34
"260060 Alagoinha";4;0;0;2;0;3;9
"260070 Aliança";8;1;0;23;0;33;65
"260080 Altinho";6;0;0;4;0;15;25
"260090 Amaraji";3;4;0;15;0;16;38
"260100 Angelim";1;0;0;6;0;6;13
"260105 Araçoiaba";5;1;0;5;0;15;26
"260110 Araripina";6;2;0;33;0;26;67
"260120 Arcoverde";16;2;0;38;1;58;115
"260130 Barra de Guabiraba";3;1;0;3;0;3;10
"260140 Barreiros";16;5;0;41;0;54;116
"260150 Belém de Maria";1;0;0;10;0;8;19
"260160 Belém de São Francisco";3;2;0;7;0;10;22
"260170 Belo Jardim";14;2;0;39;0;52;107
"260180 Betânia";0;0;0;0;0;19;19
"260190 Bezerros";18;1;0;24;0;46;89
"260200 Bodocó";1;0;0;5;0;10;16
"260210 Bom Conselho";1;1;0;7;0;15;24
"260220 Bom Jardim";5;0;0;12;0;27;44
"260230 Bonito";8;3;0;14;0;23;48
"260240 Brejão";1;0;0;3;0;4;8
"260250 Brejinho";1;0;0;1;0;2;4
"260260 Brejo da Madre de Deus";17;0;0;17;0;19;53
"260270 Buenos Aires";0;1;0;5;0;13;19
"260280 Buíque";0;1;1;14;0;17;33
"260290 Cabo de Santo Agostinho";111;64;1;375;0;543;1094
"260300 Cabrobó";1;0;0;9;0;5;15
"260310 Cachoeirinha";8;1;0;5;0;16;30
"260320 Caetés";0;0;0;3;0;4;7
"260330 Calçado";1;0;0;3;0;1;5
"260340 Calumbi";0;0;0;0;0;1;1
"260345 Camaragibe";67;31;1;162;0;286;547
"260350 Camocim de São Félix";4;0;0;8;0;13;25
"260360 Camutanga";1;0;1;0;0;7;9
"260370 Canhotinho";1;0;0;5;0;8;14
"260380 Capoeiras";2;0;0;4;0;6;12
"260390 Carnaíba";0;0;0;0;0;5;5
"260392 Carnaubeira da Penha";0;0;0;0;1;2;3
"260400 Carpina";14;5;0;85;0;84;188
"260410 Caruaru";253;30;2;410;1;401;1097
"260415 Casinhas";2;0;0;7;0;3;12
"260420 Catende";11;2;0;38;0;38;89
"260430 Cedro";1;0;0;1;0;2;4
"260440 Chã de Alegria";1;2;0;10;0;7;20
"260450 Chã Grande";3;1;0;10;0;11;25
"260460 Condado";5;2;0;22;0;27;56
"260470 Correntes";2;0;0;9;0;7;18
"260480 Cortês";1;3;0;6;0;5;15
"260490 Cumaru";3;0;0;7;0;5;15
"260500 Cupira";8;2;0;12;0;13;35
"260510 Custódia";4;2;0;9;0;16;31
"260515 Dormentes";0;0;0;1;0;0;1
"260520 Escada";26;20;0;96;0;101;243
"260530 Exu";0;0;0;3;0;10;13
"260540 Feira Nova";7;1;0;10;0;18;36
"260545 Fernando de Noronha";0;0;0;3;0;4;7
"260550 Ferreiros";2;0;0;4;0;9;15
"260560 Flores";0;0;0;3;0;10;13
"260570 Floresta";0;1;0;6;0;3;10
"260580 Frei Miguelinho";2;0;0;1;0;3;6
"260590 Gameleira";4;2;0;24;0;25;55
"260600 Garanhuns";60;5;1;91;0;99;256
"260610 Glória do Goitá";2;2;1;7;0;12;24
"260620 Goiana";40;20;0;140;0;149;349
"260640 Gravatá";27;2;0;48;0;85;162
"260650 Iati";1;1;0;4;0;3;9
"260660 Ibimirim";0;0;0;3;0;5;8
"260670 Ibirajuba";3;1;0;4;0;6;14
"260680 Igarassu";37;18;0;127;0;155;337
"260690 Iguaraci";0;0;0;2;0;3;5
"260760 Ilha de Itamaracá";8;4;0;28;0;47;87
"260700 Inajá";2;1;0;1;0;7;11
"260710 Ingazeira";0;0;0;0;0;2;2
"260720 Ipojuca";29;32;0;151;1;183;396
"260730 Ipubi";0;0;0;3;0;7;10
"260740 Itacuruba";0;1;0;0;0;1;2
"260750 Itaíba";1;0;0;1;0;3;5
"260765 Itambé";15;5;1;38;0;34;93
"260770 Itapetim";1;0;0;3;0;9;13
"260775 Itapissuma";12;10;1;48;0;82;153
"260780 Itaquitinga";0;4;0;11;0;10;25
"260790 Jaboatão dos Guararapes";525;173;8;1251;3;1695;3655
"260795 Jaqueira";2;0;0;5;0;3;10
"260800 Jataúba";0;1;0;2;0;4;7
"260805 Jatobá";1;1;0;0;0;3;5
"260810 João Alfredo";9;1;0;11;1;11;33
"260820 Joaquim Nabuco";1;1;0;7;0;14;23
"260825 Jucati";1;0;0;4;0;1;6
"260830 Jupi";0;1;0;9;0;5;15
"260840 Jurema";4;1;0;4;0;3;12
"260845 Lagoa do Carro";0;3;0;2;0;10;15
"260850 Lagoa do Itaenga";6;1;0;18;0;15;40
"260860 Lagoa do Ouro";5;0;0;5;0;9;19
"260870 Lagoa dos Gatos";3;0;0;9;0;6;18
"260875 Lagoa Grande";0;0;1;4;0;8;13
"260880 Lajedo";7;1;1;18;0;18;45
"260890 Limoeiro";18;5;0;46;0;82;151
"260900 Macaparana";3;2;0;3;0;6;14
"260910 Machados";1;0;0;3;0;7;11
"260915 Manari";0;0;0;1;0;2;3
"260920 Maraial";0;0;0;6;0;6;12
"260930 Mirandiba";3;2;0;3;0;2;10
"261430 Moreilândia";1;0;0;1;0;1;3
"260940 Moreno";21;10;0;45;0;64;140
"260950 Nazaré da Mata";2;7;0;13;0;29;51
"260960 Olinda";230;98;3;614;6;1499;2450
"260970 Orobó";1;1;0;2;0;12;16
"260980 Orocó";0;0;0;2;0;0;2
"260990 Ouricuri";2;0;0;15;0;21;38
"261000 Palmares";22;9;0;61;0;69;161
"261010 Palmeirina";4;0;0;1;0;1;6
"261020 Panelas";0;0;0;4;0;5;9
"261030 Paranatama";3;0;0;1;0;3;7
"261040 Parnamirim";1;0;0;6;0;5;12
"261050 Passira";5;1;0;10;0;12;28
"261060 Paudalho";8;4;1;40;0;50;103
"261070 Paulista";173;55;4;465;3;772;1472
"261080 Pedra";3;1;0;3;0;8;15
"261090 Pesqueira";14;5;0;27;0;39;85
"261100 Petrolândia";2;1;0;9;0;16;28
"261110 Petrolina";44;16;2;296;1;353;712
"261120 Poção";3;1;0;3;0;1;8
"261130 Pombos";6;4;0;10;0;18;38
"261140 Primavera";2;2;0;12;0;18;34
"261150 Quipapá";3;0;0;5;0;4;12
"261153 Quixaba";3;0;0;1;0;2;6
"261160 Recife";1376;598;20;3407;11;5523;10935
"261170 Riacho das Almas";2;1;0;6;0;10;19
"261180 Ribeirão";11;6;2;41;0;37;97
"261190 Rio Formoso";4;6;0;25;0;37;72
"261200 Sairé";1;1;0;2;0;5;9
"261210 Salgadinho";0;0;0;2;0;2;4
"261220 Salgueiro";8;2;0;36;0;43;89
"261230 Saloá";0;0;0;2;0;1;3
"261240 Sanharó";5;0;0;10;0;11;26
"261245 Santa Cruz";1;0;0;0;0;3;4
"261247 Santa Cruz da Baixa Verde";1;0;0;2;0;0;3
"261250 Santa Cruz do Capibaribe";32;1;0;59;0;63;155
"261255 Santa Filomena";0;0;0;0;0;1;1
"261260 Santa Maria da Boa Vista";1;0;0;14;0;8;23
"261270 Santa Maria do Cambucá";0;1;0;3;0;7;11
"261280 Santa Terezinha";0;2;0;2;0;5;9
"261290 São Benedito do Sul";0;0;0;4;0;0;4
"261300 São Bento do Una";10;2;0;12;0;22;46
"261310 São Caitano";18;4;0;25;0;25;72
"261320 São João";1;0;0;9;0;3;13
"261330 São Joaquim do Monte";3;0;0;6;0;13;22
"261340 São José da Coroa Grande";2;2;0;16;1;27;48
"261350 São José do Belmonte";2;0;0;12;0;12;26
"261360 São José do Egito";5;0;0;4;0;11;20
"261370 São Lourenço da Mata";48;22;2;96;0;180;348
"261380 São Vicente Ferrer";1;2;0;4;0;13;20
"261390 Serra Talhada";9;4;0;32;0;49;94
"261400 Serrita";2;0;0;7;0;8;17
"261410 Sertânia";9;1;0;12;0;27;49
"261420 Sirinhaém";8;8;0;31;0;43;90
"261450 Surubim";13;1;0;29;1;56;100
"261460 Tabira";2;1;0;9;0;10;22
"261470 Tacaimbó";2;0;0;2;0;6;10
"261480 Tacaratu";0;0;0;2;3;0;5
"261485 Tamandaré";4;8;0;36;0;31;79
"261500 Taquaritinga do Norte";5;1;0;9;0;18;33
"261520 Terra Nova";1;0;0;2;0;2;5
"261530 Timbaúba";10;1;1;31;0;47;90
"261540 Toritama";5;0;0;8;0;13;26
"261550 Tracunhaém";0;1;0;6;0;3;10
"261560 Trindade";7;3;0;16;0;22;48
"261570 Triunfo";0;0;0;1;0;11;12
"261580 Tupanatinga";0;0;0;0;0;4;4
"261590 Tuparetama";0;0;0;5;0;5;10
"261600 Venturosa";3;0;0;4;0;7;14
"261610 Verdejante";4;0;0;2;0;4;10
"261618 Vertente do Lério";0;0;0;1;0;4;5
"261620 Vertentes";5;0;0;5;0;11;21
"261630 Vicência";1;2;0;13;0;17;33
"261640 Vitória de Santo Antão";67;21;0;104;1;230;423
"261650 Xexéu";4;0;0;9;0;10;23
"260000 Município ignorado - PE";0;0;0;0;0;8;8
"270010 Água Branca";0;0;0;2;0;3;5
"270020 Anadia";2;1;0;10;0;7;20
"270030 Arapiraca";22;7;0;155;0;124;308
"270040 Atalaia";6;3;0;26;0;7;42
"270050 Barra de Santo Antônio";2;1;0;21;0;16;40
"270060 Barra de São Miguel";1;3;0;4;0;3;11
"270070 Batalha";0;0;0;4;0;3;7
"270080 Belém";0;0;0;3;0;6;9
"270100 Boca da Mata";3;1;0;16;0;8;28
"270110 Branquinha";1;0;0;5;0;2;8
"270120 Cacimbinhas";1;0;0;1;0;2;4
"270130 Cajueiro";2;0;0;5;0;6;13
"270135 Campestre";0;1;0;6;0;2;9
"270140 Campo Alegre";1;4;0;23;0;9;37
"270150 Campo Grande";0;0;0;1;0;3;4
"270160 Canapi";1;0;0;2;0;5;8
"270170 Capela";1;0;0;7;0;2;10
"270190 Chã Preta";0;0;0;4;0;1;5
"270200 Coité do Nóia";1;0;0;5;0;1;7
"270210 Colônia Leopoldina";3;1;0;10;0;7;21
"270220 Coqueiro Seco";0;0;0;5;0;2;7
"270230 Coruripe";5;1;0;23;0;18;47
"270235 Craíbas";0;1;0;2;0;10;13
"270240 Delmiro Gouveia";4;0;0;26;0;17;47
"270250 Dois Riachos";0;1;0;3;0;4;8
"270255 Estrela de Alagoas";0;0;0;0;0;5;5
"270260 Feira Grande";0;1;0;4;0;5;10
"270270 Feliz Deserto";0;0;0;1;0;2;3
"270280 Flexeiras";1;1;0;9;0;7;18
"270290 Girau do Ponciano";1;0;0;4;0;7;12
"270300 Ibateguara";1;0;0;4;0;6;11
"270310 Igaci";2;0;0;10;0;3;15
"270320 Igreja Nova";0;0;0;3;0;3;6
"270330 Inhapi";1;0;0;1;0;2;4
"270340 Jacaré dos Homens";0;0;0;4;0;0;4
"270350 Jacuípe";0;0;0;2;0;1;3
"270360 Japaratinga";0;0;0;4;0;2;6
"270375 Jequiá da Praia";1;0;0;4;0;2;7
"270380 Joaquim Gomes";3;1;0;22;0;6;32
"270390 Jundiá";0;0;0;3;0;0;3
"270400 Junqueiro";1;0;0;19;0;9;29
"270410 Lagoa da Canoa";1;1;0;4;0;2;8
"270420 Limoeiro de Anadia";1;0;0;11;0;3;15
"270430 Maceió";436;178;2;1877;2;1543;4038
"270440 Major Isidoro";1;0;0;4;0;3;8
"270450 Maragogi";4;6;0;31;0;11;52
"270460 Maravilha";0;0;0;6;0;2;8
"270470 Marechal Deodoro";9;3;0;40;0;30;82
"270480 Maribondo";0;0;0;3;0;2;5
"270500 Mata Grande";0;1;0;4;0;2;7
"270510 Matriz de Camaragibe";1;4;1;38;0;14;58
"270520 Messias";2;1;0;15;0;8;26
"270530 Minador do Negrão";1;0;0;0;0;0;1
"270540 Monteirópolis";1;0;0;2;0;0;3
"270550 Murici";3;3;0;43;0;14;63
"270560 Novo Lino";0;1;0;12;0;6;19
"270570 Olho d'Água das Flores";2;0;0;5;0;5;12
"270580 Olho d'Água do Casado";0;0;0;3;0;2;5
"270590 Olho d'Água Grande";0;0;0;1;0;3;4
"270600 Olivença";0;0;0;12;0;2;14
"270610 Ouro Branco";0;0;0;3;0;0;3
"270620 Palestina";0;0;0;2;0;0;2
"270630 Palmeira dos Índios";7;5;0;36;2;37;87
"270640 Pão de Açúcar";1;0;0;7;0;9;17
"270642 Pariconha";0;0;0;1;0;1;2
"270644 Paripueira";0;2;0;6;0;8;16
"270650 Passo de Camaragibe";0;1;0;5;0;8;14
"270660 Paulo Jacinto";0;0;0;3;0;3;6
"270670 Penedo";2;1;0;29;0;22;54
"270680 Piaçabuçu";0;0;0;14;0;4;18
"270690 Pilar";2;6;0;33;0;16;57
"270700 Pindoba";0;0;0;1;0;0;1
"270710 Piranhas";1;0;0;12;0;7;20
"270720 Poço das Trincheiras";0;0;0;0;0;1;1
"270730 Porto Calvo";3;3;0;30;0;8;44
"270740 Porto de Pedras";0;0;0;6;0;6;12
"270750 Porto Real do Colégio";1;1;0;12;2;2;18
"270760 Quebrangulo";1;0;0;4;0;4;9
"270770 Rio Largo";10;2;1;64;0;37;114
"270780 Roteiro";0;0;0;0;0;1;1
"270790 Santa Luzia do Norte";3;0;0;2;0;2;7
"270800 Santana do Ipanema";7;1;0;19;0;13;40
"270810 Santana do Mundaú";0;0;0;2;0;1;3
"270820 São Brás";0;0;0;4;0;2;6
"270830 São José da Laje";3;3;0;12;0;6;24
"270840 São José da Tapera";4;0;0;6;0;7;17
"270850 São Luís do Quitunde";1;4;0;35;0;16;56
"270860 São Miguel dos Campos";8;3;0;52;1;41;105
"270870 São Miguel dos Milagres";0;2;0;2;0;2;6
"270880 São Sebastião";1;0;0;16;0;7;24
"270890 Satuba";3;1;0;8;0;6;18
"270895 Senador Rui Palmeira";0;0;0;1;0;0;1
"270900 Tanque d'Arca";0;0;0;3;0;3;6
"270910 Taquarana";1;0;0;3;0;5;9
"270915 Teotônio Vilela";1;2;0;22;0;16;41
"270920 Traipu";0;0;0;1;0;0;1
"270930 União dos Palmares";10;5;0;46;0;39;100
"270940 Viçosa";2;0;0;11;0;8;21
"280010 Amparo de São Francisco";0;0;0;2;0;4;6
"280020 Aquidabã";1;1;0;2;0;8;12
"280030 Aracaju";159;79;7;816;1;1067;2129
"280040 Arauá";1;1;0;4;0;4;10
"280050 Areia Branca";3;1;0;14;0;15;33
"280060 Barra dos Coqueiros";7;4;0;29;0;30;70
"280067 Boquim";4;3;0;20;0;40;67
"280070 Brejo Grande";0;0;0;3;0;3;6
"280100 Campo do Brito";5;2;0;22;0;28;57
"280110 Canhoba";0;1;0;1;0;2;4
"280120 Canindé de São Francisco";2;1;0;24;0;12;39
"280130 Capela";4;3;1;20;0;22;50
"280140 Carira";2;0;0;8;0;12;22
"280150 Carmópolis";2;1;0;15;0;10;28
"280160 Cedro de São João";6;2;0;16;0;10;34
"280170 Cristinápolis";2;3;0;13;0;5;23
"280190 Cumbe";0;0;0;1;0;6;7
"280200 Divina Pastora";0;0;0;2;0;2;4
"280210 Estância";13;12;1;64;0;69;159
"280220 Feira Nova";0;0;0;5;0;0;5
"280230 Frei Paulo";1;0;0;5;0;9;15
"280250 General Maynard";1;1;0;3;0;1;6
"280260 Gracho Cardoso";0;0;0;2;0;1;3
"280270 Ilha das Flores";1;2;1;6;0;1;11
"280280 Indiaroba";0;1;0;4;0;7;12
"280290 Itabaiana";19;6;0;96;1;106;228
"280300 Itabaianinha";6;0;2;18;0;13;39
"280310 Itabi";2;0;0;0;0;2;4
"280320 Itaporanga d'Ajuda";3;2;0;20;0;11;36
"280330 Japaratuba";4;4;0;12;0;13;33
"280340 Japoatã";0;0;0;5;0;3;8
"280350 Lagarto";17;3;0;39;1;83;143
"280360 Laranjeiras";4;2;1;16;0;15;38
"280370 Macambira";1;0;0;0;0;1;2
"280380 Malhada dos Bois";1;0;0;2;0;2;5
"280390 Malhador";1;1;0;5;0;9;16
"280400 Maruim";3;1;0;6;0;12;22
"280410 Moita Bonita";1;0;0;7;0;7;15
"280420 Monte Alegre de Sergipe";2;0;0;4;0;4;10
"280430 Muribeca";1;1;0;1;0;1;4
"280440 Neópolis";0;2;0;9;0;8;19
"280445 Nossa Senhora Aparecida";0;0;0;1;0;4;5
"280450 Nossa Senhora da Glória";5;0;0;15;0;12;32
"280460 Nossa Senhora das Dores";5;1;0;18;0;17;41
"280480 Nossa Senhora do Socorro";31;17;0;195;0;180;423
"280490 Pacatuba";0;0;0;4;0;2;6
"280500 Pedra Mole";0;0;0;0;0;2;2
"280510 Pedrinhas";1;1;0;9;0;9;20
"280520 Pinhão";1;0;0;3;0;3;7
"280530 Pirambu";1;1;0;3;0;3;8
"280540 Poço Redondo";3;1;0;6;0;7;17
"280550 Poço Verde";3;1;0;7;0;5;16
"280560 Porto da Folha";3;1;0;3;0;4;11
"280570 Propriá";4;3;0;62;0;44;113
"280580 Riachão do Dantas";1;0;0;4;0;6;11
"280590 Riachuelo";0;2;0;4;0;2;8
"280600 Ribeirópolis";1;0;0;5;0;17;23
"280610 Rosário do Catete";1;0;0;3;0;14;18
"280620 Salgado";2;1;0;8;0;14;25
"280630 Santa Luzia do Itanhy";2;0;0;4;0;3;9
"280640 Santana do São Francisco";0;1;0;8;0;5;14
"280660 Santo Amaro das Brotas";1;1;0;7;0;3;12
"280670 São Cristóvão";11;10;0;70;0;63;154
"280680 São Domingos";0;0;1;2;0;11;14
"280690 São Francisco";0;0;0;4;0;2;6
"280700 São Miguel do Aleixo";0;0;0;1;0;0;1
"280710 Simão Dias";1;1;0;9;0;28;39
"280720 Siriri";0;0;0;3;0;2;5
"280730 Telha";0;1;0;1;0;1;3
"280740 Tobias Barreto";0;1;0;27;0;26;54
"280750 Tomar do Geru";0;0;0;4;0;6;10
"280760 Umbaúba";2;2;0;14;0;14;32
"280000 Município ignorado - SE";1;0;0;0;0;5;6
"290010 Abaíra";2;0;0;2;0;4;8
"290020 Abaré";0;0;0;0;0;1;1
"290030 Acajutiba";0;0;0;3;0;10;13
"290035 Adustina";0;0;0;4;0;3;7
"290040 Água Fria";1;0;0;2;0;1;4
"290060 Aiquara";0;2;0;2;1;3;8
"290070 Alagoinhas";19;12;0;39;1;139;210
"290080 Alcobaça";4;2;0;8;0;21;35
"290090 Almadina";0;0;0;0;0;1;1
"290100 Amargosa";1;3;0;19;0;25;48
"290110 Amélia Rodrigues";2;9;1;8;0;21;41
"290115 América Dourada";1;0;0;2;0;1;4
"290120 Anagé";3;0;0;1;0;5;9
"290130 Andaraí";1;1;0;1;0;7;10
"290135 Andorinha";1;0;0;3;0;2;6
"290140 Angical";3;1;0;1;0;3;8
"290150 Anguera";0;0;0;1;0;0;1
"290160 Antas";0;0;0;0;0;1;1
"290170 Antônio Cardoso";0;1;0;0;0;2;3
"290180 Antônio Gonçalves";0;1;0;1;0;2;4
"290190 Aporá";0;0;0;1;0;6;7
"290205 Araças";0;1;0;4;0;5;10
"290200 Aracatu";3;0;0;1;0;2;6
"290210 Araci";5;2;0;6;0;19;32
"290220 Aramari";0;1;0;1;0;1;3
"290225 Arataca";0;0;0;5;0;4;9
"290230 Aratuípe";1;0;0;2;0;6;9
"290240 Aurelino Leal";0;0;0;4;0;8;12
"290250 Baianópolis";0;0;0;0;0;2;2
"290260 Baixa Grande";0;0;0;2;0;5;7
"290265 Banzaê";0;0;0;2;0;4;6
"290270 Barra";4;3;0;9;0;16;32
"290280 Barra da Estiva";0;0;0;3;0;1;4
"290290 Barra do Choça";2;4;0;19;0;17;42
"290300 Barra do Mendes";1;0;0;0;0;5;6
"290310 Barra do Rocha";0;0;0;1;0;5;6
"290320 Barreiras";31;18;1;61;4;116;231
"290323 Barro Alto";2;2;0;0;0;1;5
"290330 Barro Preto";0;0;0;1;0;2;3
"290327 Barrocas";2;0;0;3;0;6;11
"290340 Belmonte";2;5;0;20;0;31;58
"290350 Belo Campo";5;2;0;7;0;5;19
"290360 Biritinga";0;0;0;1;0;1;2
"290370 Boa Nova";1;0;0;4;0;5;10
"290380 Boa Vista do Tupim";0;0;0;0;0;7;7
"290390 Bom Jesus da Lapa";6;11;4;21;0;50;92
"290395 Bom Jesus da Serra";0;0;0;0;0;3;3
"290400 Boninal";1;0;0;0;0;3;4
"290405 Bonito";0;0;0;1;0;2;3
"290410 Boquira";3;0;0;1;0;3;7
"290420 Botuporã";0;1;0;0;0;1;2
"290430 Brejões";1;1;0;4;0;12;18
"290440 Brejolândia";0;0;0;0;0;2;2
"290450 Brotas de Macaúbas";0;0;0;0;0;2;2
"290460 Brumado";14;1;0;31;0;17;63
"290470 Buerarema";4;0;0;3;0;22;29
"290475 Buritirama";0;0;0;1;0;2;3
"290480 Caatiba";1;1;0;1;0;4;7
"290485 Cabaceiras do Paraguaçu";0;1;0;11;0;3;15
"290490 Cachoeira";0;18;0;17;0;45;80
"290500 Caculé";4;2;0;3;0;5;14
"290510 Caém";0;0;0;1;0;3;4
"290515 Caetanos";1;0;0;1;0;1;3
"290520 Caetité";3;2;0;1;0;8;14
"290530 Cafarnaum";2;1;0;3;0;2;8
"290540 Cairu";2;7;0;2;0;15;26
"290550 Caldeirão Grande";0;1;0;1;0;8;10
"290560 Camacan";4;3;0;21;0;42;70
"290570 Camaçari";41;36;1;187;2;287;554
"290580 Camamu";2;0;0;2;0;6;10
"290590 Campo Alegre de Lourdes";0;1;0;6;0;5;12
"290600 Campo Formoso";5;4;0;9;0;19;37
"290610 Canápolis";0;0;0;0;0;1;1
"290620 Canarana";0;0;0;1;0;2;3
"290630 Canavieiras";1;0;0;10;0;38;49
"290640 Candeal";0;0;0;1;0;1;2
"290650 Candeias";11;26;0;53;0;119;209
"290660 Candiba";0;0;0;2;0;2;4
"290670 Cândido Sales";4;0;0;28;0;17;49
"290680 Cansanção";1;1;0;6;0;10;18
"290682 Canudos";0;0;0;0;0;2;2
"290685 Capela do Alto Alegre";1;0;0;3;0;2;6
"290687 Capim Grosso";4;3;0;17;0;21;45
"290689 Caraíbas";1;0;0;3;0;4;8
"290690 Caravelas";0;2;0;6;0;11;19
"290700 Cardeal da Silva";1;0;0;3;0;1;5
"290710 Carinhanha";3;1;0;2;0;2;8
"290720 Casa Nova";7;2;0;23;0;8;40
"290730 Castro Alves";0;0;0;12;0;6;18
"290750 Catu";4;4;0;11;0;38;57
"290755 Caturama";0;0;0;0;0;2;2
"290760 Central";0;0;0;3;0;7;10
"290780 Cícero Dantas";2;0;1;3;0;8;14
"290790 Cipó";2;0;1;5;0;7;15
"290800 Coaraci";1;1;0;2;0;9;13
"290810 Cocos";0;0;0;1;0;5;6
"290820 Conceição da Feira";0;1;0;3;0;10;14
"290830 Conceição do Almeida";1;0;0;1;0;3;5
"290840 Conceição do Coité";7;5;0;17;0;35;64
"290850 Conceição do Jacuípe";1;9;1;11;0;21;43
"290860 Conde";0;1;0;16;0;10;27
"290870 Condeúba";1;0;0;4;0;2;7
"290880 Contendas do Sincorá";0;1;0;0;0;0;1
"290890 Coração de Maria";0;2;0;1;0;7;10
"290910 Coribe";0;0;0;0;0;1;1
"290920 Coronel João Sá";0;0;0;4;0;1;5
"290930 Correntina";2;3;0;4;0;6;15
"290940 Cotegipe";1;0;0;0;0;2;3
"290950 Cravolândia";0;0;0;0;0;1;1
"290960 Crisópolis";1;0;0;1;0;5;7
"290970 Cristópolis";0;0;0;2;0;4;6
"290980 Cruz das Almas";6;12;0;14;0;45;77
"290990 Curaçá";4;2;0;12;0;7;25
"291000 Dário Meira";0;0;0;1;0;4;5
"291005 Dias d'Ávila";12;17;0;50;0;71;150
"291010 Dom Basílio";5;0;0;1;0;1;7
"291020 Dom Macedo Costa";0;0;0;0;0;3;3
"291030 Elísio Medrado";1;0;0;2;0;3;6
"291040 Encruzilhada";1;0;0;2;0;0;3
"291050 Entre Rios";6;1;0;9;0;25;41
"290050 Érico Cardoso";1;0;0;3;0;2;6
"291060 Esplanada";3;0;0;8;0;13;24
"291070 Euclides da Cunha";4;1;1;7;0;25;38
"291072 Eunápolis";30;22;0;217;1;182;452
"291075 Fátima";1;0;0;1;0;3;5
"291077 Feira da Mata";0;0;0;0;0;1;1
"291080 Feira de Santana";136;184;21;359;1;806;1507
"291085 Filadélfia";0;2;0;4;0;3;9
"291100 Floresta Azul";0;0;0;2;0;7;9
"291110 Formosa do Rio Preto";1;0;0;6;0;8;15
"291120 Gandu";0;2;0;6;0;17;25
"291125 Gavião";0;0;0;0;0;1;1
"291130 Gentio do Ouro";0;0;0;0;0;1;1
"291140 Glória";2;0;0;1;0;8;11
"291150 Gongogi";0;0;0;1;0;5;6
"291160 Governador Mangabeira";0;0;0;8;0;13;21
"291165 Guajeru";0;0;0;2;0;0;2
"291170 Guanambi";14;12;0;17;1;25;69
"291180 Guaratinga";0;0;0;5;0;7;12
"291185 Heliópolis";0;0;0;2;0;5;7
"291190 Iaçu";4;4;0;11;0;32;51
"291200 Ibiassucê";1;0;0;1;0;2;4
"291210 Ibicaraí";1;0;0;4;1;15;21
"291220 Ibicoara";0;0;0;4;0;2;6
"291230 Ibicuí";3;0;0;5;0;6;14
"291240 Ibipeba";1;0;0;3;0;2;6
"291250 Ibipitanga";4;0;0;2;0;3;9
"291270 Ibirapitanga";2;1;0;4;0;11;18
"291280 Ibirapuã";1;0;0;4;0;8;13
"291290 Ibirataia";1;1;0;1;0;9;12
"291300 Ibitiara";0;1;0;1;0;5;7
"291310 Ibititá";0;0;0;0;0;4;4
"291320 Ibotirama";0;1;0;3;0;18;22
"291330 Ichu";0;1;0;0;0;1;2
"291340 Igaporã";0;1;0;0;0;2;3
"291345 Igrapiúna";0;0;0;2;0;3;5
"291350 Iguaí";2;0;0;2;0;6;10
"291360 Ilhéus";20;26;0;110;0;392;548
"291370 Inhambupe";3;1;0;1;0;14;19
"291380 Ipecaetá";1;0;0;4;0;5;10
"291390 Ipiaú";6;5;0;9;0;43;63
"291400 Ipirá";4;6;0;25;0;48;83
"291410 Ipupiara";0;0;0;1;0;2;3
"291420 Irajuba";0;0;0;1;0;5;6
"291430 Iramaia";0;1;0;1;0;2;4
"291440 Iraquara";0;0;0;6;0;7;13
"291450 Irará";0;2;0;8;0;14;24
"291460 Irecê";12;6;0;22;0;48;88
"291465 Itabela";11;3;0;45;0;45;104
"291470 Itaberaba";5;6;1;36;0;53;101
"291480 Itabuna";27;18;2;98;0;502;647
"291490 Itacaré";0;1;0;5;0;21;27
"291500 Itaeté";1;0;0;0;0;5;6
"291510 Itagi";0;0;0;5;0;6;11
"291520 Itagibá";0;0;0;2;0;6;8
"291530 Itagimirim";0;2;0;11;0;10;23
"291535 Itaguaçu da Bahia";0;0;0;0;0;2;2
"291540 Itaju do Colônia";0;0;0;1;0;2;3
"291550 Itajuípe";3;1;0;5;0;19;28
"291560 Itamaraju";10;16;0;87;1;110;224
"291570 Itamari";0;0;0;1;0;3;4
"291580 Itambé";3;3;0;8;0;7;21
"291590 Itanagra";1;0;0;0;0;0;1
"291600 Itanhém";1;0;0;1;0;14;16
"291610 Itaparica";2;7;0;10;0;37;56
"291620 Itapé";2;0;0;2;0;11;15
"291630 Itapebi";1;2;0;7;0;7;17
"291640 Itapetinga";14;12;0;44;0;28;98
"291650 Itapicuru";0;0;0;4;0;3;7
"291660 Itapitanga";0;0;0;0;0;2;2
"291670 Itaquara";1;0;0;2;0;2;5
"291680 Itarantim";2;1;0;3;0;7;13
"291685 Itatim";2;2;0;6;0;7;17
"291690 Itiruçu";2;1;0;3;0;8;14
"291700 Itiúba";1;0;0;3;0;8;12
"291710 Itororó";1;1;0;4;0;12;18
"291720 Ituaçu";1;0;0;6;0;0;7
"291730 Ituberá";0;1;0;2;0;8;11
"291735 Jaborandi";0;1;0;2;0;2;5
"291740 Jacaraci";0;0;0;4;0;0;4
"291750 Jacobina";4;1;0;8;0;37;50
"291760 Jaguaquara";0;0;0;4;1;17;22
"291770 Jaguarari";2;2;2;6;0;14;26
"291780 Jaguaripe";1;0;0;3;0;9;13
"291790 Jandaíra";0;0;0;0;0;3;3
"291800 Jequié";26;24;0;93;0;202;345
"291810 Jeremoabo";4;2;0;3;0;17;26
"291820 Jiquiriçá";1;1;0;3;0;4;9
"291830 Jitaúna";0;0;0;0;0;5;5
"291835 João Dourado";2;3;0;2;0;5;12
"291840 Juazeiro";90;57;10;255;1;220;633
"291845 Jucuruçu";0;0;0;5;0;0;5
"291850 Jussara";0;0;0;4;0;6;10
"291855 Jussari";0;0;0;0;0;8;8
"291870 Lafaiete Coutinho";0;0;0;0;0;1;1
"291875 Lagoa Real";1;0;0;0;0;0;1
"291880 Laje";1;0;0;6;0;8;15
"291890 Lajedão";0;0;0;1;0;2;3
"291900 Lajedinho";0;0;0;0;0;1;1
"291905 Lajedo do Tabocal";2;0;0;0;0;0;2
"291910 Lamarão";0;0;0;1;0;2;3
"291915 Lapão";0;0;0;3;0;5;8
"291920 Lauro de Freitas";40;56;0;141;1;309;547
"291930 Lençóis";0;0;0;2;0;9;11
"291940 Licínio de Almeida";0;0;2;5;0;3;10
"291950 Livramento de Nossa Senhora";2;1;0;5;0;6;14
"291955 Luís Eduardo Magalhães";18;7;0;27;1;32;85
"291960 Macajuba";2;0;0;0;0;6;8
"291970 Macarani";0;0;0;3;0;1;4
"291980 Macaúbas";3;0;0;6;0;6;15
"291990 Macururé";1;0;0;0;0;1;2
"291992 Madre de Deus";1;7;0;15;0;37;60
"291995 Maetinga";0;0;0;1;0;0;1
"292000 Maiquinique";1;0;0;1;0;2;4
"292010 Mairi";2;0;0;6;0;5;13
"292020 Malhada";0;2;0;4;1;3;10
"292030 Malhada de Pedras";2;0;0;2;0;1;5
"292040 Manoel Vitorino";2;0;0;2;0;3;7
"292045 Mansidão";0;0;0;1;0;2;3
"292050 Maracás";4;1;0;6;0;13;24
"292060 Maragogipe";2;3;1;13;0;23;42
"292070 Maraú";0;0;0;1;0;7;8
"292080 Marcionílio Souza";0;1;0;3;0;2;6
"292090 Mascote";0;0;0;2;0;7;9
"292100 Mata de São João";5;6;0;14;0;37;62
"292105 Matina";1;0;0;0;0;0;1
"292110 Medeiros Neto";1;1;0;7;0;37;46
"292120 Miguel Calmon";1;0;0;5;0;5;11
"292130 Milagres";1;2;0;10;0;7;20
"292140 Mirangaba";1;0;0;2;0;2;5
"292145 Mirante";0;1;0;0;0;2;3
"292150 Monte Santo";0;2;1;3;0;12;18
"292170 Morro do Chapéu";0;3;0;3;0;9;15
"292180 Mortugaba";2;0;0;0;0;3;5
"292190 Mucugê";3;0;0;5;0;3;11
"292200 Mucuri";4;1;1;12;0;59;77
"292205 Mulungu do Morro";1;0;0;1;0;2;4
"292210 Mundo Novo";0;4;0;0;0;7;11
"292220 Muniz Ferreira";2;0;0;0;0;7;9
"292230 Muritiba";1;8;0;15;0;25;49
"292240 Mutuípe";1;3;0;2;0;7;13
"292250 Nazaré";4;9;0;21;0;19;53
"292260 Nilo Peçanha";0;0;0;0;0;1;1
"292265 Nordestina";0;2;0;3;0;2;7
"292270 Nova Canaã";2;3;0;3;0;4;12
"292273 Nova Fátima";0;1;0;3;0;4;8
"292275 Nova Ibiá";0;1;0;0;0;0;1
"292280 Nova Itarana";0;1;0;3;0;3;7
"292285 Nova Redenção";0;0;0;0;0;2;2
"292290 Nova Soure";0;1;0;4;0;4;9
"292300 Nova Viçosa";0;8;1;12;0;45;66
"292303 Novo Horizonte";3;0;0;0;0;0;3
"292305 Novo Triunfo";0;1;0;2;0;4;7
"292310 Olindina";4;0;0;8;0;5;17
"292320 Oliveira dos Brejinhos";1;0;0;0;1;6;8
"292330 Ouriçangas";0;0;0;1;1;1;3
"292335 Ourolândia";1;0;0;5;0;6;12
"292340 Palmas de Monte Alto";1;0;0;3;0;4;8
"292350 Palmeiras";1;1;0;3;0;6;11
"292360 Paramirim";1;1;0;6;0;1;9
"292370 Paratinga";0;2;0;2;0;2;6
"292380 Paripiranga";2;0;0;1;0;10;13
"292390 Pau Brasil";0;0;0;5;1;16;22
"292400 Paulo Afonso";15;2;0;40;0;119;176
"292405 Pé de Serra";1;0;0;1;0;0;2
"292410 Pedrão";0;0;0;1;0;3;4
"292420 Pedro Alexandre";0;0;0;2;0;3;5
"292430 Piatã";2;2;0;3;0;8;15
"292440 Pilão Arcado";2;0;0;1;0;1;4
"292450 Pindaí";0;1;0;0;0;2;3
"292460 Pindobaçu";0;1;0;2;0;6;9
"292465 Pintadas";0;0;0;1;0;3;4
"292470 Piripá";0;0;0;1;0;4;5
"292480 Piritiba";0;0;0;2;0;4;6
"292490 Planaltino";2;0;0;2;0;3;7
"292500 Planalto";8;5;0;21;0;17;51
"292510 Poções";11;4;0;30;0;23;68
"292520 Pojuca";2;7;0;14;1;16;40
"292525 Ponto Novo";0;3;0;5;0;5;13
"292530 Porto Seguro";56;53;1;144;8;288;550
"292540 Potiraguá";0;1;0;3;0;3;7
"292550 Prado";3;5;0;9;1;52;70
"292560 Presidente Dutra";2;0;0;2;0;2;6
"292575 Presidente Tancredo Neves";2;2;0;7;0;3;14
"292580 Queimadas";0;0;0;2;0;15;17
"292590 Quijingue";0;0;0;1;0;2;3
"292593 Quixabeira";1;0;0;1;0;2;4
"292595 Rafael Jambeiro";1;1;0;3;0;13;18
"292600 Remanso";19;23;2;44;0;57;145
"292610 Retirolândia";1;2;0;4;0;4;11
"292620 Riachão das Neves";0;0;0;3;0;3;6
"292630 Riachão do Jacuípe";2;1;0;5;0;23;31
"292640 Riacho de Santana";4;0;0;6;0;3;13
"292650 Ribeira do Amparo";2;0;0;2;0;11;15
"292660 Ribeira do Pombal";7;0;0;10;0;35;52
"292665 Ribeirão do Largo";0;1;0;0;0;2;3
"292670 Rio de Contas";1;0;0;1;0;2;4
"292680 Rio do Antônio";0;2;0;2;0;2;6
"292690 Rio do Pires";1;0;0;2;0;2;5
"292700 Rio Real";4;1;0;12;0;10;27
"292710 Rodelas";0;0;0;0;0;1;1
"292720 Ruy Barbosa";1;1;0;10;0;16;28
"292730 Salinas da Margarida";0;6;0;6;0;6;18
"292740 Salvador";867;1461;28;3177;20;8711;14264
"292750 Santa Bárbara";1;1;0;9;0;15;26
"292760 Santa Brígida";0;0;0;0;0;6;6
"292770 Santa Cruz Cabrália";10;4;0;15;2;30;61
"292780 Santa Cruz da Vitória";0;0;0;2;0;3;5
"292790 Santa Inês";2;1;0;2;0;15;20
"292805 Santa Luzia";1;1;0;3;0;10;15
"292810 Santa Maria da Vitória";4;0;0;3;0;6;13
"292840 Santa Rita de Cássia";2;3;0;13;1;8;27
"292850 Santa Teresinha";0;1;0;1;0;1;3
"292800 Santaluz";4;4;0;11;1;20;40
"292820 Santana";1;1;0;2;0;5;9
"292830 Santanópolis";0;0;0;0;0;1;1
"292860 Santo Amaro";2;14;0;20;0;50;86
"292870 Santo Antônio de Jesus";17;22;0;55;0;65;159
"292880 Santo Estêvão";2;14;0;19;0;49;84
"292890 São Desidério";2;2;0;5;0;14;23
"292895 São Domingos";0;0;0;1;0;3;4
"292910 São Felipe";0;2;0;3;0;8;13
"292900 São Félix";1;6;0;12;0;21;40
"292905 São Félix do Coribe";2;0;0;8;0;2;12
"292920 São Francisco do Conde";0;4;0;19;0;29;52
"292925 São Gabriel";3;1;0;1;0;4;9
"292930 São Gonçalo dos Campos";3;4;0;7;0;11;25
"292935 São José da Vitória";0;0;0;2;0;5;7
"292937 São José do Jacuípe";1;2;0;2;0;4;9
"292940 São Miguel das Matas";0;0;0;2;0;3;5
"292950 São Sebastião do Passé";3;5;0;19;0;22;49
"292960 Sapeaçu";2;2;0;1;0;11;16
"292975 Saubara";0;0;0;4;0;14;18
"292980 Saúde";0;0;0;3;0;3;6
"292990 Seabra";7;1;0;6;0;23;37
"293000 Sebastião Laranjeiras";1;0;0;1;0;1;3
"293010 Senhor do Bonfim";11;11;1;80;0;96;199
"293020 Sento Sé";1;2;0;5;0;11;19
"293015 Serra do Ramalho";1;0;0;3;0;2;6
"293030 Serra Dourada";0;0;0;0;0;2;2
"293040 Serra Preta";1;0;0;2;0;3;6
"293050 Serrinha";3;7;0;29;1;85;125
"293060 Serrolândia";0;2;0;2;0;5;9
"293070 Simões Filho";18;33;0;99;0;156;306
"293075 Sítio do Mato";0;0;0;2;0;6;8
"293076 Sítio do Quinto";0;0;0;0;0;1;1
"293077 Sobradinho";2;1;0;10;0;7;20
"293080 Souto Soares";4;0;0;0;0;3;7
"293090 Tabocas do Brejo Velho";0;0;0;0;0;1;1
"293100 Tanhaçu";3;0;0;3;0;8;14
"293105 Tanque Novo";2;0;0;1;0;0;3
"293110 Tanquinho";0;1;0;2;0;8;11
"293120 Taperoá";0;0;0;1;0;8;9
"293130 Tapiramutá";1;0;0;1;0;5;7
"293135 Teixeira de Freitas";35;16;1;82;1;231;366
"293140 Teodoro Sampaio";0;1;0;3;0;4;8
"293150 Teofilândia";1;2;0;4;0;6;13
"293160 Teolândia";1;1;0;2;0;5;9
"293170 Terra Nova";0;2;0;1;0;4;7
"293180 Tremedal";1;1;0;1;0;4;7
"293190 Tucano";4;1;0;5;0;10;20
"293200 Uauá";1;0;0;2;0;5;8
"293210 Ubaíra";0;4;0;0;0;7;11
"293220 Ubaitaba";0;0;0;3;0;22;25
"293230 Ubatã";1;0;0;3;0;7;11
"293240 Uibaí";1;0;0;2;0;3;6
"293245 Umburanas";0;0;0;2;0;2;4
"293250 Una";4;3;0;11;0;22;40
"293260 Urandi";0;0;0;2;0;0;2
"293270 Uruçuca";0;1;0;3;0;17;21
"293280 Utinga";0;1;0;6;0;5;12
"293290 Valença";11;31;0;64;0;132;238
"293300 Valente";0;0;0;1;0;3;4
"293305 Várzea da Roça";2;0;0;2;0;2;6
"293310 Várzea do Poço";0;0;0;2;0;0;2
"293315 Várzea Nova";1;1;0;1;0;2;5
"293317 Varzedo";1;0;0;4;0;1;6
"293320 Vera Cruz";12;9;0;24;1;46;92
"293325 Vereda";0;0;0;0;0;3;3
"293330 Vitória da Conquista";148;86;1;260;2;247;744
"293340 Wagner";0;0;0;2;0;2;4
"293345 Wanderley";0;0;0;0;0;6;6
"293350 Wenceslau Guimarães";0;2;0;3;0;10;15
"293360 Xique-Xique";2;3;0;13;0;33;51
"290000 Município ignorado - BA";1;1;0;5;0;107;114
"310010 Abadia dos Dourados";0;0;0;1;0;4;5
"310020 Abaeté";9;5;0;14;0;32;60
"310030 Abre Campo";0;1;0;0;0;3;4
"310040 Acaiaca";0;0;0;0;0;6;6
"310050 Açucena";0;0;0;0;0;5;5
"310060 Água Boa";1;1;0;0;0;1;3
"310070 Água Comprida";1;0;0;1;0;0;2
"310080 Aguanil";1;0;0;0;0;2;3
"310090 Águas Formosas";6;3;0;41;0;9;59
"310100 Águas Vermelhas";0;0;0;4;0;2;6
"310110 Aimorés";6;1;0;3;0;14;24
"310120 Aiuruoca";1;2;0;0;0;0;3
"310130 Alagoa";0;0;0;0;0;2;2
"310140 Albertina";0;1;0;0;0;1;2
"310150 Além Paraíba";28;16;1;10;0;71;126
"310160 Alfenas";104;17;1;20;0;94;236
"310163 Alfredo Vasconcelos";1;1;0;1;0;2;5
"310170 Almenara";3;3;0;35;0;9;50
"310180 Alpercata";4;0;0;3;0;7;14
"310190 Alpinópolis";3;1;0;2;0;11;17
"310200 Alterosa";6;0;0;0;0;6;12
"315350 Alto Jequitibá";1;0;0;1;0;7;9
"310210 Alto Rio Doce";1;0;0;0;0;1;2
"310220 Alvarenga";0;0;0;0;0;2;2
"310230 Alvinópolis";3;0;0;3;0;10;16
"310250 Amparo do Serra";4;1;0;1;0;4;10
"310260 Andradas";33;0;0;2;0;29;64
"310280 Andrelândia";3;2;0;0;0;5;10
"310290 Antônio Carlos";2;0;0;1;0;10;13
"310300 Antônio Dias";1;1;0;2;0;3;7
"310310 Antônio Prado de Minas";1;0;0;0;0;0;1
"310320 Araçaí";0;0;0;1;0;1;2
"310330 Aracitaba";2;0;0;0;0;2;4
"310340 Araçuaí";1;2;0;9;0;35;47
"310350 Araguari";250;60;2;117;1;244;674
"310360 Arantina";0;0;0;1;0;2;3
"310370 Araponga";0;0;0;0;0;1;1
"310375 Araporã";1;1;0;1;0;8;11
"310380 Arapuá";4;0;0;0;0;2;6
"310390 Araújos";1;0;0;1;0;1;3
"310400 Araxá";106;33;0;37;0;175;351
"310410 Arceburgo";3;0;0;1;0;1;5
"310420 Arcos";19;1;0;6;0;33;59
"310430 Areado";5;1;0;0;0;10;16
"310440 Argirita";3;1;0;1;0;0;5
"310445 Aricanduva";0;0;0;1;0;0;1
"310450 Arinos";1;0;0;1;0;1;3
"310460 Astolfo Dutra";5;2;0;1;0;18;26
"310470 Ataléia";0;0;0;7;0;1;8
"310480 Augusto de Lima";1;1;0;3;0;2;7
"310490 Baependi";4;0;0;0;0;15;19
"310500 Baldim";4;0;0;5;0;9;18
"310510 Bambuí";11;1;0;10;1;15;38
"310520 Bandeira";0;0;0;1;0;3;4
"310530 Bandeira do Sul";0;0;0;0;0;3;3
"310540 Barão de Cocais";8;4;3;18;0;25;58
"310550 Barão de Monte Alto";2;1;0;0;0;5;8
"310560 Barbacena";36;10;3;27;0;179;255
"310570 Barra Longa";0;0;0;0;0;3;3
"310590 Barroso";8;6;0;5;0;20;39
"310600 Bela Vista de Minas";3;1;1;7;0;20;32
"310610 Belmiro Braga";2;0;0;0;0;2;4
"310620 Belo Horizonte";3084;882;32;2384;11;8059;14452
"310630 Belo Oriente";5;2;0;3;0;12;22
"310640 Belo Vale";2;1;0;0;0;3;6
"310650 Berilo";0;0;0;0;0;2;2
"310665 Berizal";1;0;0;0;0;1;2
"310660 Bertópolis";0;0;0;3;0;1;4
"310670 Betim";265;92;3;249;1;900;1510
"310680 Bias Fortes";1;1;0;0;0;3;5
"310690 Bicas";14;7;0;6;0;35;62
"310710 Boa Esperança";18;6;0;6;0;35;65
"310720 Bocaina de Minas";1;1;0;0;0;0;2
"310730 Bocaiúva";4;4;0;24;0;35;67
"310740 Bom Despacho";21;6;0;11;0;19;57
"310750 Bom Jardim de Minas";15;1;0;5;0;12;33
"310760 Bom Jesus da Penha";3;0;0;0;0;0;3
"310770 Bom Jesus do Amparo";0;0;0;0;0;1;1
"310780 Bom Jesus do Galho";3;0;0;1;0;5;9
"310790 Bom Repouso";3;0;0;0;0;9;12
"310800 Bom Sucesso";6;0;2;4;0;9;21
"310810 Bonfim";1;0;0;1;0;1;3
"310825 Bonito de Minas";1;0;0;1;0;0;2
"310830 Borda da Mata";8;0;0;2;0;12;22
"310840 Botelhos";3;0;0;0;0;1;4
"310850 Botumirim";0;0;0;2;0;1;3
"310870 Brás Pires";1;2;0;1;0;2;6
"310855 Brasilândia de Minas";0;0;0;4;0;1;5
"310860 Brasília de Minas";4;1;0;13;0;13;31
"310890 Brasópolis";9;0;0;0;0;7;16
"310880 Braúnas";1;0;0;1;0;6;8
"310900 Brumadinho";9;2;0;8;0;32;51
"310910 Bueno Brandão";2;0;0;0;0;3;5
"310920 Buenópolis";2;3;0;8;0;13;26
"310925 Bugre";0;0;0;1;0;1;2
"310930 Buritis";1;0;0;2;0;3;6
"310940 Buritizeiro";2;1;0;5;0;17;25
"310945 Cabeceira Grande";0;0;0;1;0;1;2
"310950 Cabo Verde";1;0;0;1;0;2;4
"310960 Cachoeira da Prata";2;1;1;2;0;3;9
"310970 Cachoeira de Minas";4;1;0;1;0;9;15
"310270 Cachoeira de Pajeú";2;0;0;1;0;1;4
"310980 Cachoeira Dourada";0;0;0;0;0;1;1
"310990 Caetanópolis";1;1;0;7;0;7;16
"311000 Caeté";16;2;0;25;0;62;105
"311010 Caiana";0;0;0;0;0;3;3
"311020 Cajuri";0;0;0;0;0;2;2
"311030 Caldas";4;0;0;0;0;10;14
"311040 Camacho";0;0;0;1;0;0;1
"311050 Camanducaia";15;4;0;1;0;27;47
"311060 Cambuí";9;1;0;0;0;24;34
"311070 Cambuquira";9;4;0;1;0;9;23
"311080 Campanário";0;0;0;6;0;6;12
"311090 Campanha";7;1;0;0;0;24;32
"311100 Campestre";6;0;0;2;0;5;13
"311110 Campina Verde";5;4;1;7;0;21;38
"311115 Campo Azul";0;0;0;3;0;3;6
"311120 Campo Belo";25;6;1;19;0;42;93
"311130 Campo do Meio";7;1;0;0;0;11;19
"311140 Campo Florido";6;0;0;4;0;14;24
"311150 Campos Altos";8;2;0;7;0;18;35
"311160 Campos Gerais";11;2;0;2;0;13;28
"311190 Cana Verde";3;1;0;0;0;1;5
"311170 Canaã";0;0;0;2;0;4;6
"311180 Canápolis";4;1;1;3;0;3;12
"311200 Candeias";3;0;0;5;0;8;16
"311205 Cantagalo";1;0;0;0;0;0;1
"311210 Caparaó";0;0;0;0;0;2;2
"311220 Capela Nova";0;0;0;0;0;4;4
"311230 Capelinha";1;1;0;7;0;19;28
"311240 Capetinga";1;0;0;1;0;2;4
"311250 Capim Branco";2;0;0;4;0;3;9
"311260 Capinópolis";12;1;0;15;0;15;43
"311265 Capitão Andrade";1;0;0;0;0;1;2
"311270 Capitão Enéas";0;1;0;1;0;3;5
"311280 Capitólio";1;0;0;0;0;2;3
"311300 Caraí";6;0;0;21;0;10;37
"311310 Caranaíba";0;0;0;0;0;2;2
"311320 Carandaí";4;0;0;4;0;19;27
"311330 Carangola";22;3;0;1;1;63;90
"311340 Caratinga";11;8;0;15;0;95;129
"311350 Carbonita";1;0;0;0;0;3;4
"311360 Careaçu";5;0;0;1;0;17;23
"311370 Carlos Chagas";5;0;0;15;0;14;34
"311380 Carmésia";0;0;0;0;0;1;1
"311390 Carmo da Cachoeira";9;7;0;2;0;19;37
"311400 Carmo da Mata";9;4;0;4;0;19;36
"311410 Carmo de Minas";3;1;0;3;0;16;23
"311420 Carmo do Cajuru";5;4;0;5;0;9;23
"311430 Carmo do Paranaíba";23;7;0;9;0;28;67
"311440 Carmo do Rio Claro";14;1;0;2;0;14;31
"311450 Carmópolis de Minas";8;0;0;1;0;1;10
"311455 Carneirinho";0;0;0;1;0;4;5
"311460 Carrancas";0;1;0;0;0;4;5
"311470 Carvalhópolis";1;0;0;0;0;0;1
"311480 Carvalhos";1;0;0;1;0;5;7
"311490 Casa Grande";0;0;0;0;0;2;2
"311500 Cascalho Rico";2;2;0;1;0;2;7
"311510 Cássia";7;1;0;5;0;15;28
"311530 Cataguases";76;27;0;18;0;120;241
"311535 Catas Altas";0;0;0;5;0;2;7
"311540 Catas Altas da Noruega";0;0;0;0;0;3;3
"311545 Catuji";0;2;0;16;0;3;21
"311550 Caxambu";16;7;0;1;0;23;47
"311560 Cedro do Abaeté";0;0;0;0;0;1;1
"311570 Central de Minas";0;0;0;1;0;7;8
"311580 Centralina";4;0;0;0;0;4;8
"311590 Chácara";4;0;0;1;0;3;8
"311600 Chalé";0;1;0;0;0;3;4
"311610 Chapada do Norte";1;2;0;5;0;10;18
"311620 Chiador";2;3;0;3;0;6;14
"311630 Cipotânea";1;0;0;0;0;2;3
"311640 Claraval";0;1;0;0;0;1;2
"311650 Claro dos Poções";0;0;0;1;0;3;4
"311660 Cláudio";13;1;0;0;0;16;30
"311670 Coimbra";0;0;0;0;0;5;5
"311680 Coluna";0;0;0;0;0;5;5
"311690 Comendador Gomes";0;0;0;1;0;3;4
"311710 Conceição da Aparecida";5;1;0;1;0;4;11
"311520 Conceição da Barra de Minas";0;0;0;0;0;4;4
"311730 Conceição das Alagoas";12;2;1;11;0;41;67
"311740 Conceição de Ipanema";0;1;0;0;0;0;1
"311750 Conceição do Mato Dentro";4;1;0;2;0;13;20
"311760 Conceição do Pará";1;0;0;2;0;2;5
"311770 Conceição do Rio Verde";1;1;0;1;0;4;7
"311780 Conceição dos Ouros";4;0;0;0;0;8;12
"311783 Cônego Marinho";0;0;0;0;0;1;1
"311787 Confins";3;1;0;2;0;2;8
"311790 Congonhal";1;1;0;1;0;8;11
"311800 Congonhas";12;7;0;8;0;52;79
"311810 Congonhas do Norte";0;0;0;0;0;1;1
"311820 Conquista";2;1;0;1;0;7;11
"311830 Conselheiro Lafaiete";24;11;1;32;0;109;177
"311840 Conselheiro Pena";3;2;0;2;0;22;29
"311850 Consolação";3;0;0;0;0;3;6
"311860 Contagem";516;182;2;475;2;1400;2577
"311880 Coração de Jesus";0;1;0;3;0;4;8
"311890 Cordisburgo";0;1;0;1;0;1;3
"311900 Cordislândia";0;1;0;0;0;2;3
"311910 Corinto";2;6;0;13;0;19;40
"311920 Coroaci";0;0;0;0;0;5;5
"311930 Coromandel";8;3;0;3;0;16;30
"311940 Coronel Fabriciano";31;12;0;21;0;220;284
"311950 Coronel Murta";0;0;0;1;0;4;5
"311960 Coronel Pacheco";0;0;0;0;0;8;8
"311970 Coronel Xavier Chaves";0;1;0;0;0;0;1
"311980 Córrego Danta";3;0;0;1;0;5;9
"311990 Córrego do Bom Jesus";2;0;0;0;0;2;4
"311995 Córrego Fundo";0;0;0;1;0;3;4
"312000 Córrego Novo";1;0;0;1;0;3;5
"312010 Couto de Magalhães de Minas";0;0;0;4;0;4;8
"312015 Crisólita";0;0;0;8;0;1;9
"312020 Cristais";2;0;0;0;0;1;3
"312030 Cristália";0;0;0;1;0;3;4
"312040 Cristiano Otoni";0;1;0;1;0;9;11
"312050 Cristina";5;1;0;0;0;6;12
"312060 Crucilândia";0;0;0;1;0;3;4
"312070 Cruzeiro da Fortaleza";0;0;0;2;0;1;3
"312080 Cruzília";1;4;0;1;0;7;13
"312087 Curral de Dentro";0;0;0;0;0;2;2
"312090 Curvelo";37;13;0;36;0;89;175
"312100 Datas";1;1;0;0;0;3;5
"312110 Delfim Moreira";7;0;0;1;0;7;15
"312120 Delfinópolis";0;0;0;1;0;2;3
"312125 Delta";10;1;0;3;0;11;25
"312130 Descoberto";2;2;0;1;0;7;12
"312140 Desterro de Entre Rios";3;0;0;0;0;0;3
"312150 Desterro do Melo";1;0;0;0;0;0;1
"312160 Diamantina";6;3;0;17;0;49;75
"312170 Diogo de Vasconcelos";1;0;0;0;0;2;3
"312180 Dionísio";0;2;0;1;0;0;3
"312190 Divinésia";2;1;0;0;0;4;7
"312200 Divino";1;0;0;1;0;12;14
"312210 Divino das Laranjeiras";0;1;0;0;0;1;2
"312220 Divinolândia de Minas";1;0;0;1;0;2;4
"312230 Divinópolis";190;29;0;64;1;274;558
"312235 Divisa Alegre";3;1;0;5;0;2;11
"312240 Divisa Nova";2;1;0;1;0;2;6
"312245 Divisópolis";2;0;0;3;0;2;7
"312247 Dom Bosco";0;0;0;0;0;1;1
"312250 Dom Cavati";2;0;0;1;0;7;10
"312260 Dom Joaquim";1;0;0;0;0;1;2
"312270 Dom Silvério";0;0;0;1;0;0;1
"312290 Dona Eusébia";2;1;0;0;0;1;4
"312300 Dores de Campos";0;1;0;1;0;1;3
"312310 Dores de Guanhães";1;0;0;0;0;5;6
"312320 Dores do Indaiá";10;1;0;4;0;11;26
"312330 Dores do Turvo";1;0;0;1;0;3;5
"312350 Douradoquara";0;0;0;0;0;1;1
"312352 Durandé";0;0;0;1;0;3;4
"312360 Elói Mendes";5;1;0;0;0;20;26
"312370 Engenheiro Caldas";4;0;0;0;0;14;18
"312380 Engenheiro Navarro";2;2;0;3;0;4;11
"312385 Entre Folhas";0;0;0;0;0;2;2
"312390 Entre Rios de Minas";3;2;1;1;0;7;14
"312400 Ervália";1;0;0;1;0;4;6
"312410 Esmeraldas";24;16;0;33;0;68;141
"312420 Espera Feliz";3;1;0;1;0;32;37
"312430 Espinosa";2;0;0;5;0;8;15
"312450 Estiva";5;0;0;1;0;4;10
"312460 Estrela Dalva";0;3;0;0;0;3;6
"312470 Estrela do Indaiá";4;3;0;0;0;2;9
"312480 Estrela do Sul";5;2;0;3;0;8;18
"312490 Eugenópolis";3;0;0;1;0;14;18
"312500 Ewbank da Câmara";3;2;0;2;0;2;9
"312510 Extrema";41;5;0;5;0;56;107
"312520 Fama";3;1;0;0;0;1;5
"312530 Faria Lemos";1;0;0;0;0;2;3
"312540 Felício dos Santos";0;0;0;1;0;4;5
"312560 Felisburgo";0;0;0;2;0;3;5
"312570 Felixlândia";5;0;0;3;0;5;13
"312580 Fernandes Tourinho";0;0;0;1;0;6;7
"312590 Ferros";2;2;0;0;0;3;7
"312595 Fervedouro";2;0;0;0;0;0;2
"312600 Florestal";0;0;0;0;0;6;6
"312610 Formiga";51;8;0;21;0;89;169
"312630 Fortaleza de Minas";5;1;0;1;0;5;12
"312640 Fortuna de Minas";0;0;0;1;0;2;3
"312650 Francisco Badaró";0;0;0;3;0;4;7
"312660 Francisco Dumont";0;0;0;0;0;2;2
"312670 Francisco Sá";1;0;0;3;0;3;7
"312675 Franciscópolis";0;0;0;3;0;2;5
"312680 Frei Gaspar";0;0;0;1;0;4;5
"312690 Frei Inocêncio";2;2;0;3;0;15;22
"312700 Fronteira";14;3;0;7;0;37;61
"312705 Fronteira dos Vales";0;0;0;6;0;3;9
"312710 Frutal";78;21;0;46;0;247;392
"312720 Funilândia";4;0;0;2;0;4;10
"312730 Galiléia";0;0;0;3;0;7;10
"312735 Glaucilândia";0;0;0;0;0;1;1
"312737 Goiabeira";0;0;0;1;0;4;5
"312738 Goianá";2;1;0;0;0;1;4
"312740 Gonçalves";5;0;0;0;0;2;7
"312750 Gonzaga";0;0;0;0;0;5;5
"312760 Gouveia";1;0;0;1;0;10;12
"312770 Governador Valadares";101;37;1;133;0;587;859
"312780 Grão Mogol";0;0;0;0;0;5;5
"312790 Grupiara";0;1;0;0;0;1;2
"312800 Guanhães";4;3;0;4;0;9;20
"312810 Guapé";2;4;1;1;0;8;16
"312820 Guaraciaba";0;0;0;0;0;5;5
"312830 Guaranésia";10;0;0;0;0;10;20
"312840 Guarani";5;2;0;2;0;6;15
"312850 Guarará";2;1;0;2;0;4;9
"312870 Guaxupé";45;3;0;4;0;56;108
"312880 Guidoval";2;0;0;0;0;8;10
"312890 Guimarânia";6;1;0;2;0;6;15
"312900 Guiricema";1;0;1;1;0;2;5
"312910 Gurinhatã";3;0;0;2;0;9;14
"312920 Heliodora";3;1;0;0;0;2;6
"312930 Iapu";0;1;0;2;0;7;10
"312950 Ibiá";14;4;0;12;0;49;79
"312960 Ibiaí";0;0;0;1;0;0;1
"312970 Ibiraci";4;5;0;4;0;12;25
"312980 Ibirité";67;43;0;105;1;300;516
"312990 Ibitiúra de Minas";2;1;1;0;0;2;6
"313000 Ibituruna";1;0;0;0;0;1;2
"313005 Icaraí de Minas";0;1;0;6;0;5;12
"313010 Igarapé";17;8;1;9;0;58;93
"313020 Igaratinga";1;0;0;3;0;4;8
"313030 Iguatama";0;0;0;1;0;3;4
"313040 Ijaci";4;0;0;0;0;1;5
"313050 Ilicínea";1;0;0;0;0;5;6
"313055 Imbé de Minas";1;0;0;1;0;4;6
"313060 Inconfidentes";1;0;0;1;0;5;7
"313065 Indaiabira";0;0;0;0;0;1;1
"313070 Indianópolis";1;0;0;2;0;3;6
"313080 Ingaí";0;0;0;0;0;1;1
"313090 Inhapim";2;1;0;2;0;13;18
"313100 Inhaúma";5;3;0;6;0;6;20
"313110 Inimutaba";1;0;0;0;0;4;5
"313115 Ipaba";1;4;0;5;0;23;33
"313120 Ipanema";4;0;0;2;0;6;12
"313130 Ipatinga";104;49;0;104;1;539;797
"313140 Ipiaçu";1;0;0;0;0;6;7
"313150 Ipuiúna";1;0;0;0;0;6;7
"313160 Iraí de Minas";3;1;0;1;0;4;9
"313170 Itabira";41;22;12;51;1;195;322
"313180 Itabirinha";3;0;0;5;0;1;9
"313190 Itabirito";23;5;1;24;0;56;109
"313200 Itacambira";0;0;0;1;0;1;2
"313210 Itacarambi";3;4;0;14;0;15;36
"313220 Itaguara";7;0;0;5;0;16;28
"313230 Itaipé";0;0;0;8;0;1;9
"313240 Itajubá";143;16;0;21;0;196;376
"313250 Itamarandiba";4;0;0;4;0;9;17
"313260 Itamarati de Minas";1;0;0;0;0;4;5
"313270 Itambacuri";2;7;0;27;0;11;47
"313290 Itamogi";10;0;0;2;0;14;26
"313300 Itamonte";9;0;0;1;0;4;14
"313310 Itanhandu";11;2;0;4;0;19;36
"313320 Itanhomi";2;0;0;0;0;6;8
"313330 Itaobim";3;1;1;20;0;19;44
"313340 Itapagipe";7;1;0;4;0;19;31
"313350 Itapecerica";3;1;0;1;0;19;24
"313360 Itapeva";6;2;0;0;0;8;16
"313370 Itatiaiuçu";4;4;0;1;0;11;20
"313375 Itaú de Minas";7;0;0;1;0;9;17
"313380 Itaúna";49;14;0;40;0;113;216
"313400 Itinga";0;0;0;3;0;4;7
"313410 Itueta";1;0;0;2;0;1;4
"313420 Ituiutaba";151;30;2;71;0;169;423
"313430 Itumirim";1;1;0;2;0;1;5
"313440 Iturama";31;7;1;14;0;61;114
"313450 Itutinga";0;0;0;0;0;1;1
"313460 Jaboticatubas";7;1;0;5;0;10;23
"313470 Jacinto";3;0;0;5;0;1;9
"313480 Jacuí";1;1;0;0;0;3;5
"313490 Jacutinga";2;0;0;1;0;12;15
"313500 Jaguaraçu";1;1;0;0;0;2;4
"313505 Jaíba";0;0;0;3;0;3;6
"313507 Jampruca";0;1;0;1;0;2;4
"313510 Janaúba";4;0;1;18;0;18;41
"313520 Januária";5;5;0;14;0;35;59
"313530 Japaraíba";1;0;0;3;0;1;5
"313535 Japonvar";0;0;0;1;0;0;1
"313540 Jeceaba";0;0;0;1;0;1;2
"313545 Jenipapo de Minas";0;1;0;3;0;8;12
"313550 Jequeri";1;1;0;0;0;5;7
"313560 Jequitaí";0;1;0;3;0;3;7
"313570 Jequitibá";0;0;0;1;0;1;2
"313580 Jequitinhonha";1;1;0;14;0;12;28
"313590 Jesuânia";2;0;0;0;0;3;5
"313600 Joaíma";0;0;0;8;0;4;12
"313610 Joanésia";1;0;0;2;0;2;5
"313620 João Monlevade";39;30;2;45;0;98;214
"313630 João Pinheiro";16;2;0;9;0;29;56
"313640 Joaquim Felício";1;1;0;0;0;4;6
"313650 Jordânia";1;0;0;0;0;1;2
"313655 José Raydan";0;1;0;0;0;0;1
"313657 Josenópolis";0;0;0;0;0;3;3
"313665 Juatuba";13;7;0;10;0;31;61
"313670 Juiz de Fora";1093;532;4;417;1;2076;4123
"313690 Juruaia";3;0;0;0;0;1;4
"313695 Juvenília";0;0;0;0;0;1;1
"313700 Ladainha";1;0;0;7;0;6;14
"313710 Lagamar";2;0;0;0;0;1;3
"313720 Lagoa da Prata";22;6;0;14;0;36;78
"313730 Lagoa dos Patos";0;0;0;0;0;5;5
"313740 Lagoa Dourada";3;0;0;1;0;0;4
"313750 Lagoa Formosa";5;1;0;5;0;7;18
"313753 Lagoa Grande";1;1;0;0;0;2;4
"313760 Lagoa Santa";29;7;1;32;0;79;148
"313770 Lajinha";2;0;0;1;0;11;14
"313780 Lambari";18;6;0;2;0;35;61
"313790 Lamim";1;0;1;1;0;2;5
"313800 Laranjal";0;0;0;1;0;7;8
"313810 Lassance";0;0;0;3;0;8;11
"313820 Lavras";118;26;1;36;0;108;289
"313830 Leandro Ferreira";1;0;0;1;0;1;3
"313835 Leme do Prado";1;0;0;0;0;0;1
"313840 Leopoldina";44;33;1;21;0;78;177
"313850 Liberdade";3;0;0;0;0;4;7
"313860 Lima Duarte";9;4;0;3;0;10;26
"313862 Limeira do Oeste";2;3;0;0;0;3;8
"313865 Lontra";2;0;0;2;0;7;11
"313867 Luisburgo";2;0;0;0;0;3;5
"313868 Luislândia";0;0;0;0;0;1;1
"313870 Luminárias";0;1;0;0;0;3;4
"313880 Luz";14;6;0;6;0;19;45
"313890 Machacalis";1;1;0;7;0;5;14
"313900 Machado";10;4;0;3;0;15;32
"313910 Madre de Deus de Minas";1;3;0;0;0;1;5
"313920 Malacacheta";2;0;0;3;0;2;7
"313925 Mamonas";0;0;0;2;0;3;5
"313930 Manga";0;3;0;9;0;12;24
"313940 Manhuaçu";22;7;2;8;0;127;166
"313950 Manhumirim";6;0;0;1;0;19;26
"313960 Mantena";8;4;0;2;0;15;29
"313980 Mar de Espanha";11;7;0;6;0;21;45
"313970 Maravilhas";0;1;0;0;0;0;1
"313990 Maria da Fé";3;1;0;1;0;10;15
"314000 Mariana";12;6;0;11;0;45;74
"314010 Marilac";1;1;0;1;0;2;5
"314015 Mário Campos";4;7;0;6;0;23;40
"314020 Maripá de Minas";5;3;0;0;0;5;13
"314030 Marliéria";1;0;0;1;0;3;5
"314050 Martinho Campos";4;0;0;4;0;6;14
"314053 Martins Soares";3;0;0;0;0;1;4
"314055 Mata Verde";1;0;0;0;0;2;3
"314070 Mateus Leme";10;2;0;9;0;34;55
"317150 Mathias Lobato";0;1;0;1;0;7;9
"314080 Matias Barbosa";15;6;0;8;0;20;49
"314085 Matias Cardoso";1;0;0;2;0;1;4
"314090 Matipó";1;0;0;0;0;0;1
"314100 Mato Verde";0;0;0;0;0;1;1
"314110 Matozinhos";18;9;1;33;0;65;126
"314120 Matutina";0;0;0;0;0;4;4
"314130 Medeiros";1;0;0;0;0;1;2
"314140 Medina";6;1;0;22;0;15;44
"314150 Mendes Pimentel";0;1;0;1;0;4;6
"314160 Mercês";2;1;0;2;0;0;5
"314170 Mesquita";0;2;0;2;0;7;11
"314180 Minas Novas";2;3;0;5;0;16;26
"314190 Minduri";3;0;0;0;0;2;5
"314200 Mirabela";1;0;1;1;0;9;12
"314210 Miradouro";1;0;0;1;0;13;15
"314220 Miraí";11;6;0;5;0;20;42
"314230 Moeda";2;0;0;0;0;2;4
"314240 Moema";2;0;0;0;0;4;6
"314260 Monsenhor Paulo";0;1;0;0;0;4;5
"314270 Montalvânia";0;0;0;3;0;1;4
"314280 Monte Alegre de Minas";18;3;0;3;0;34;58
"314290 Monte Azul";0;0;1;2;0;3;6
"314300 Monte Belo";2;0;0;2;0;1;5
"314310 Monte Carmelo";33;6;1;10;0;64;114
"314315 Monte Formoso";3;0;0;3;0;1;7
"314320 Monte Santo de Minas";9;1;0;2;0;5;17
"314340 Monte Sião";8;1;0;1;0;20;30
"314330 Montes Claros";48;23;7;146;3;269;496
"314350 Morada Nova de Minas";3;2;0;3;0;3;11
"314360 Morro da Garça";1;0;0;1;0;3;5
"314370 Morro do Pilar";0;1;0;0;0;0;1
"314380 Munhoz";0;0;0;0;0;2;2
"314390 Muriaé";67;11;4;26;1;292;401
"314400 Mutum";0;0;0;0;0;9;9
"314410 Muzambinho";7;0;0;1;0;5;13
"314420 Nacip Raydan";0;0;0;0;0;2;2
"314430 Nanuque";8;3;0;29;0;27;67
"314435 Naque";0;1;0;1;0;6;8
"314437 Natalândia";0;0;0;0;0;1;1
"314440 Natércia";0;0;0;0;0;3;3
"314450 Nazareno";8;1;0;3;0;17;29
"314460 Nepomuceno";15;8;0;3;0;17;43
"314467 Nova Belém";1;0;0;0;0;3;4
"314470 Nova Era";7;4;0;11;0;14;36
"314480 Nova Lima";56;29;0;44;0;108;237
"314490 Nova Módica";1;0;0;2;0;1;4
"314500 Nova Ponte";3;1;0;3;0;11;18
"314505 Nova Porteirinha";0;2;0;1;0;1;4
"314510 Nova Resende";8;0;0;1;0;10;19
"314520 Nova Serrana";20;2;1;25;0;42;90
"313660 Nova União";2;0;0;2;0;2;6
"314530 Novo Cruzeiro";1;3;0;12;0;12;28
"314535 Novo Oriente de Minas";1;0;0;9;0;8;18
"314540 Olaria";1;0;0;0;0;0;1
"314545 Olhos-d'Água";0;0;0;1;0;0;1
"314550 Olímpio Noronha";0;0;0;0;0;2;2
"314560 Oliveira";15;18;0;10;0;48;91
"314580 Onça de Pitangui";1;0;0;0;0;3;4
"314585 Oratórios";2;4;0;1;0;7;14
"314587 Orizânia";0;0;0;1;0;2;3
"314590 Ouro Branco";6;3;0;13;0;31;53
"314600 Ouro Fino";14;0;0;1;0;31;46
"314610 Ouro Preto";28;11;0;28;0;63;130
"314620 Ouro Verde de Minas";0;1;0;2;0;4;7
"314630 Padre Paraíso";12;1;0;43;0;27;83
"314640 Paineiras";0;0;0;1;0;0;1
"314650 Pains";2;0;0;1;0;3;6
"314660 Paiva";0;0;0;1;0;0;1
"314670 Palma";2;2;0;0;0;4;8
"314675 Palmópolis";0;0;0;0;0;2;2
"314690 Papagaios";7;0;0;5;0;15;27
"314710 Pará de Minas";62;12;0;28;0;110;212
"314700 Paracatu";23;10;0;18;0;68;119
"314720 Paraguaçu";1;1;0;0;0;5;7
"314730 Paraisópolis";18;2;0;3;0;36;59
"314740 Paraopeba";21;2;0;13;0;32;68
"314760 Passa Quatro";8;0;0;0;0;15;23
"314770 Passa Tempo";4;1;0;1;0;4;10
"314780 Passa-Vinte";1;0;0;0;0;0;1
"314750 Passabém";0;0;0;0;0;1;1
"314790 Passos";121;33;0;18;0;242;414
"314795 Patis";0;0;0;2;0;0;2
"314800 Patos de Minas";150;15;1;27;0;174;367
"314810 Patrocínio";29;8;0;17;0;69;123
"314820 Patrocínio do Muriaé";6;0;0;0;0;4;10
"314830 Paula Cândido";0;0;0;0;0;8;8
"314840 Paulistas";0;0;1;0;0;2;3
"314850 Pavão";3;0;0;8;0;3;14
"314860 Peçanha";0;1;0;2;0;7;10
"314870 Pedra Azul";1;1;0;16;0;14;32
"314880 Pedra do Anta";1;0;0;0;0;0;1
"314890 Pedra do Indaiá";2;0;0;0;0;1;3
"314900 Pedra Dourada";1;0;0;0;0;4;5
"314910 Pedralva";5;0;0;1;0;7;13
"314915 Pedras de Maria da Cruz";0;0;0;4;0;3;7
"314920 Pedrinópolis";0;0;0;0;0;2;2
"314930 Pedro Leopoldo";21;9;0;38;0;73;141
"314940 Pedro Teixeira";1;0;0;0;0;2;3
"314950 Pequeri";1;0;1;0;0;5;7
"314960 Pequi";1;0;0;0;0;0;1
"314970 Perdigão";3;0;0;2;0;5;10
"314980 Perdizes";8;3;0;4;0;11;26
"314990 Perdões";20;4;0;7;0;19;50
"314995 Periquito";1;0;0;0;0;6;7
"315000 Pescador";0;1;0;3;0;4;8
"315010 Piau";3;0;0;0;0;0;3
"315015 Piedade de Caratinga";1;0;0;0;0;1;2
"315020 Piedade de Ponte Nova";0;0;0;2;0;6;8
"315030 Piedade do Rio Grande";0;0;0;1;0;3;4
"315040 Piedade dos Gerais";1;0;0;0;0;1;2
"315050 Pimenta";2;0;0;0;0;1;3
"315053 Pingo-d'Água";1;0;0;0;0;1;2
"315060 Piracema";3;1;0;2;0;10;16
"315070 Pirajuba";5;1;0;4;0;4;14
"315080 Piranga";0;2;0;1;0;8;11
"315090 Piranguçu";1;0;0;1;0;4;6
"315100 Piranguinho";6;2;0;0;0;11;19
"315110 Pirapetinga";2;6;0;0;0;20;28
"315120 Pirapora";6;9;0;32;0;67;114
"315130 Piraúba";2;3;0;0;0;3;8
"315140 Pitangui";12;4;0;8;0;27;51
"315150 Piumhi";24;3;0;4;0;21;52
"315160 Planura";11;6;0;6;0;26;49
"315170 Poço Fundo";3;1;0;1;0;3;8
"315180 Poços de Caldas";210;27;1;23;0;356;617
"315190 Pocrane";1;0;0;1;0;4;6
"315200 Pompéu";14;5;0;11;0;19;49
"315210 Ponte Nova";22;11;0;16;0;112;161
"315213 Ponto Chique";0;0;0;1;0;0;1
"315217 Ponto dos Volantes";1;0;0;12;0;11;24
"315220 Porteirinha";2;1;0;4;0;10;17
"315230 Porto Firme";0;0;0;0;0;4;4
"315240 Poté";1;0;0;5;0;10;16
"315250 Pouso Alegre";137;11;0;21;0;317;486
"315260 Pouso Alto";2;0;0;2;0;3;7
"315280 Prata";21;6;1;13;1;53;95
"315290 Pratápolis";0;0;0;0;0;5;5
"315300 Pratinha";1;0;0;1;0;1;3
"315310 Presidente Bernardes";0;0;0;1;0;1;2
"315320 Presidente Juscelino";0;0;0;0;0;1;1
"315330 Presidente Kubitschek";0;0;0;0;0;1;1
"315340 Presidente Olegário";4;1;0;5;0;5;15
"315360 Prudente de Morais";3;3;0;1;0;16;23
"315370 Quartel Geral";0;1;0;2;0;1;4
"315380 Queluzito";0;0;0;2;0;0;2
"315390 Raposos";5;1;0;9;0;28;43
"315400 Raul Soares";3;1;0;3;0;14;21
"315410 Recreio";5;5;0;3;0;17;30
"315415 Reduto";0;0;0;0;0;8;8
"315420 Resende Costa";0;0;1;1;0;6;8
"315430 Resplendor";4;1;0;2;0;3;10
"315440 Ressaquinha";1;0;0;1;0;6;8
"315445 Riachinho";0;1;0;1;0;1;3
"315460 Ribeirão das Neves";188;108;4;273;2;583;1158
"315470 Ribeirão Vermelho";4;0;0;1;0;2;7
"315480 Rio Acima";2;0;0;3;0;8;13
"315490 Rio Casca";3;1;0;3;0;20;27
"315510 Rio do Prado";2;0;0;1;0;2;5
"315520 Rio Espera";0;0;0;0;0;5;5
"315530 Rio Manso";0;0;0;1;0;0;1
"315540 Rio Novo";5;4;1;3;0;15;28
"315550 Rio Paranaíba";1;0;0;0;0;4;5
"315560 Rio Pardo de Minas";3;1;0;6;0;15;25
"315570 Rio Piracicaba";3;4;0;6;0;13;26
"315580 Rio Pomba";4;3;0;1;0;17;25
"315590 Rio Preto";5;2;0;2;0;8;17
"315600 Rio Vermelho";0;0;0;1;0;1;2
"315620 Rochedo de Minas";1;0;0;0;0;1;2
"315630 Rodeiro";3;3;0;3;0;8;17
"315640 Romaria";0;1;0;0;0;1;2
"315645 Rosário da Limeira";1;0;0;0;0;5;6
"315660 Rubim";0;0;0;3;0;2;5
"315670 Sabará";65;40;1;119;0;309;534
"315680 Sabinópolis";0;0;0;0;0;7;7
"315690 Sacramento";5;2;0;5;0;19;31
"315700 Salinas";1;0;1;11;0;8;21
"315710 Salto da Divisa";1;0;0;7;0;3;11
"315720 Santa Bárbara";8;6;0;7;0;29;50
"315725 Santa Bárbara do Leste";0;0;0;1;0;2;3
"315727 Santa Bárbara do Monte Verde";1;0;0;0;0;3;4
"315730 Santa Bárbara do Tugúrio";1;1;0;0;0;3;5
"315733 Santa Cruz de Minas";1;1;0;3;0;5;10
"315737 Santa Cruz de Salinas";0;0;0;0;0;1;1
"315750 Santa Efigênia de Minas";0;0;0;0;0;3;3
"315760 Santa Fé de Minas";0;0;0;1;0;1;2
"315765 Santa Helena de Minas";0;1;0;4;0;2;7
"315770 Santa Juliana";2;2;0;4;0;6;14
"315780 Santa Luzia";118;61;1;180;0;441;801
"315790 Santa Margarida";0;1;0;0;0;4;5
"315800 Santa Maria de Itabira";0;1;0;0;0;7;8
"315820 Santa Maria do Suaçuí";5;1;0;6;0;11;23
"315920 Santa Rita de Caldas";7;1;0;0;0;1;9
"315930 Santa Rita de Jacutinga";3;0;0;0;0;4;7
"315935 Santa Rita de Minas";2;1;0;1;0;5;9
"315950 Santa Rita do Itueto";1;1;0;0;0;1;3
"315960 Santa Rita do Sapucaí";24;1;1;0;0;38;64
"315970 Santa Rosa da Serra";1;0;0;1;0;0;2
"315980 Santa Vitória";19;5;1;22;0;24;71
"315830 Santana da Vargem";2;0;0;1;0;6;9
"315840 Santana de Cataguases";3;0;0;0;0;2;5
"315850 Santana de Pirapama";0;0;0;2;0;2;4
"315860 Santana do Deserto";0;1;0;0;0;4;5
"315880 Santana do Jacaré";2;1;0;2;0;3;8
"315890 Santana do Manhuaçu";0;0;0;0;0;3;3
"315895 Santana do Paraíso";8;9;0;8;0;33;58
"315900 Santana do Riacho";1;1;0;1;0;5;8
"315910 Santana dos Montes";0;0;0;0;0;1;1
"315990 Santo Antônio do Amparo";13;11;0;10;0;18;52
"316000 Santo Antônio do Aventureiro";2;0;0;0;0;2;4
"316010 Santo Antônio do Grama";0;0;0;0;0;2;2
"316030 Santo Antônio do Jacinto";2;0;0;4;0;3;9
"316040 Santo Antônio do Monte";2;2;0;2;0;7;13
"316050 Santo Antônio do Rio Abaixo";0;1;0;0;0;0;1
"316060 Santo Hipólito";1;1;0;0;0;0;2
"316070 Santos Dumont";50;18;1;9;0;134;212
"316080 São Bento Abade";1;0;0;1;0;0;2
"316090 São Brás do Suaçuí";0;2;0;0;0;3;5
"316095 São Domingos das Dores";1;2;0;1;0;2;6
"316100 São Domingos do Prata";3;5;0;6;0;19;33
"316105 São Félix de Minas";2;1;0;0;0;2;5
"316110 São Francisco";1;1;0;12;1;20;35
"316120 São Francisco de Paula";1;2;0;1;0;3;7
"316130 São Francisco de Sales";1;0;0;2;0;6;9
"316140 São Francisco do Glória";3;1;0;2;0;26;32
"316150 São Geraldo";3;2;0;1;0;6;12
"316160 São Geraldo da Piedade";1;0;0;0;0;1;2
"316165 São Geraldo do Baixio";1;0;0;0;0;8;9
"316170 São Gonçalo do Abaeté";1;2;0;4;0;2;9
"316180 São Gonçalo do Pará";4;0;0;1;0;5;10
"316190 São Gonçalo do Rio Abaixo";2;2;1;3;0;11;19
"316200 São Gonçalo do Sapucaí";1;1;0;1;0;32;35
"316210 São Gotardo";25;6;1;12;0;59;103
"316220 São João Batista do Glória";1;0;0;0;0;4;5
"316225 São João da Lagoa";0;0;0;0;0;1;1
"316230 São João da Mata";1;0;0;0;0;3;4
"316240 São João da Ponte";0;0;0;3;0;5;8
"316245 São João das Missões";0;0;0;0;2;5;7
"316250 São João del Rei";48;24;4;46;0;140;262
"316255 São João do Manhuaçu";1;0;0;1;0;4;6
"316257 São João do Manteninha";0;0;0;1;0;1;2
"316260 São João do Oriente";2;0;0;1;0;7;10
"316265 São João do Pacuí";0;0;0;0;0;1;1
"316270 São João do Paraíso";2;1;0;3;0;2;8
"316280 São João Evangelista";5;0;0;0;0;10;15
"316290 São João Nepomuceno";15;4;0;5;0;29;53
"316292 São Joaquim de Bicas";15;7;0;17;0;54;93
"316294 São José da Barra";2;0;0;0;0;2;4
"316295 São José da Lapa";8;6;0;8;0;33;55
"316300 São José da Safira";0;0;0;0;0;3;3
"316320 São José do Alegre";3;0;0;0;0;2;5
"316330 São José do Divino";1;0;0;2;0;6;9
"316340 São José do Goiabal";0;0;0;2;0;6;8
"316350 São José do Jacuri";2;0;0;4;0;1;7
"316360 São José do Mantimento";0;0;0;0;0;1;1
"316370 São Lourenço";67;11;0;14;0;147;239
"316380 São Miguel do Anta";2;0;0;0;0;3;5
"316390 São Pedro da União";6;0;0;0;0;3;9
"316410 São Pedro do Suaçuí";0;1;0;0;0;1;2
"316400 São Pedro dos Ferros";1;0;0;2;0;5;8
"316420 São Romão";0;0;0;2;0;1;3
"316430 São Roque de Minas";0;0;0;0;0;1;1
"316440 São Sebastião da Bela Vista";2;0;0;3;0;7;12
"316447 São Sebastião do Anta";4;0;0;0;0;1;5
"316450 São Sebastião do Maranhão";0;0;0;1;0;1;2
"316460 São Sebastião do Oeste";3;0;0;0;0;3;6
"316470 São Sebastião do Paraíso";111;13;1;11;0;104;240
"316490 São Sebastião do Rio Verde";2;0;0;0;0;1;3
"316520 São Thomé das Letras";4;1;0;0;0;10;15
"316500 São Tiago";2;1;0;0;0;1;4
"316510 São Tomás de Aquino";2;0;0;0;0;4;6
"316530 São Vicente de Minas";1;0;0;0;0;1;2
"316540 Sapucaí-Mirim";4;0;0;0;0;2;6
"316550 Sardoá";3;0;0;3;0;4;10
"316553 Sarzedo";14;5;0;13;0;36;68
"316557 Senador Amaral";1;0;0;0;0;1;2
"316560 Senador Cortes";1;0;0;0;0;0;1
"316570 Senador Firmino";2;1;0;0;0;2;5
"316580 Senador José Bento";0;0;0;0;0;1;1
"316590 Senador Modestino Gonçalves";1;0;0;1;0;0;2
"316620 Senhora dos Remédios";1;0;0;0;0;4;5
"316630 Sericita";0;0;0;0;0;3;3
"316640 Seritinga";1;0;0;0;0;2;3
"316650 Serra Azul de Minas";1;0;0;0;0;0;1
"316680 Serra do Salitre";4;2;0;2;0;5;13
"316670 Serra dos Aimorés";6;1;0;6;0;5;18
"316690 Serrania";4;8;0;1;0;8;21
"316695 Serranópolis de Minas";1;0;0;0;0;2;3
"316710 Serro";2;0;0;2;0;9;13
"316720 Sete Lagoas";138;39;0;123;1;328;629
"316555 Setubinha";2;1;0;1;0;2;6
"316730 Silveirânia";0;0;0;0;0;1;1
"316740 Silvianópolis";2;0;0;0;0;3;5
"316750 Simão Pereira";8;0;0;0;0;4;12
"316760 Simonésia";2;1;0;2;0;7;12
"316770 Sobrália";0;0;0;0;0;2;2
"316780 Soledade de Minas";3;1;0;3;0;9;16
"316790 Tabuleiro";2;0;0;0;0;8;10
"316800 Taiobeiras";1;1;0;6;0;13;21
"316805 Taparuba";1;1;0;0;0;0;2
"316810 Tapira";0;0;0;1;0;0;1
"316820 Tapiraí";0;0;0;0;0;1;1
"316830 Taquaraçu de Minas";1;0;0;0;0;0;1
"316840 Tarumirim";2;0;0;1;0;14;17
"316850 Teixeiras";1;0;0;2;0;14;17
"316860 Teófilo Otoni";44;15;0;203;0;127;389
"316870 Timóteo";36;21;0;30;0;91;178
"316880 Tiradentes";4;1;1;1;0;7;14
"316890 Tiros";4;0;0;1;0;1;6
"316900 Tocantins";7;6;0;6;0;21;40
"316905 Tocos do Moji";0;0;0;0;0;2;2
"316910 Toledo";2;0;0;0;0;2;4
"316920 Tombos";4;2;0;7;0;6;19
"316930 Três Corações";81;19;0;23;0;191;314
"316935 Três Marias";8;5;0;8;0;20;41
"316940 Três Pontas";53;26;0;27;0;143;249
"316950 Tumiritinga";1;0;0;0;0;6;7
"316960 Tupaciguara";4;4;0;3;0;23;34
"316970 Turmalina";1;0;0;1;0;3;5
"316980 Turvolândia";1;0;0;1;0;3;5
"316990 Ubá";108;42;0;40;0;116;306
"317000 Ubaí";0;0;0;3;0;3;6
"317005 Ubaporanga";0;0;0;1;0;5;6
"317010 Uberaba";518;124;3;176;0;1457;2278
"317020 Uberlândia";1065;211;11;479;4;2049;3819
"317030 Umburatiba";0;0;0;3;0;1;4
"317040 Unaí";19;4;0;21;0;28;72
"317043 União de Minas";3;1;0;1;0;1;6
"317050 Urucânia";2;0;0;1;0;6;9
"317052 Urucuia";0;0;0;1;0;0;1
"317057 Vargem Alegre";1;0;0;1;0;6;8
"317060 Vargem Bonita";0;0;0;0;0;3;3
"317065 Vargem Grande do Rio Pardo";1;0;0;0;0;0;1
"317070 Varginha";101;28;0;11;0;248;388
"317075 Varjão de Minas";1;0;0;1;0;1;3
"317080 Várzea da Palma";2;1;0;13;0;22;38
"317090 Varzelândia";1;0;0;3;0;10;14
"317100 Vazante";8;2;0;2;0;5;17
"317103 Verdelândia";0;0;0;0;0;2;2
"317107 Veredinha";0;0;0;0;0;1;1
"317110 Veríssimo";1;0;0;1;0;3;5
"317115 Vermelho Novo";0;0;0;0;0;2;2
"317120 Vespasiano";40;35;1;76;0;265;417
"317130 Viçosa";23;19;0;7;0;66;115
"317160 Virgem da Lapa";1;0;0;3;0;8;12
"317170 Virgínia";1;0;0;0;0;1;2
"317180 Virginópolis";2;0;0;2;0;0;4
"317190 Virgolândia";1;0;0;1;0;2;4
"317200 Visconde do Rio Branco";31;12;0;11;0;36;90
"317210 Volta Grande";2;3;0;1;0;4;10
"317220 Wenceslau Braz";1;0;0;0;0;3;4
"310000 Município ignorado - MG";2;0;0;0;0;20;22
"320010 Afonso Cláudio";5;2;0;5;0;7;19
"320016 Água Doce do Norte";1;1;0;6;0;4;12
"320013 Águia Branca";2;0;0;2;0;4;8
"320020 Alegre";25;8;1;19;0;35;88
"320030 Alfredo Chaves";10;0;0;8;0;17;35
"320035 Alto Rio Novo";1;0;0;6;0;9;16
"320040 Anchieta";17;3;0;27;0;41;88
"320050 Apiacá";8;1;0;5;0;10;24
"320060 Aracruz";32;25;0;64;4;91;216
"320070 Atilio Vivacqua";7;0;0;6;0;5;18
"320080 Baixo Guandu";20;16;1;32;0;25;94
"320090 Barra de São Francisco";18;5;0;24;0;49;96
"320100 Boa Esperança";3;1;1;3;0;9;17
"320110 Bom Jesus do Norte";8;5;0;5;0;32;50
"320115 Brejetuba";2;0;0;1;0;0;3
"320120 Cachoeiro de Itapemirim";240;79;0;286;0;337;942
"320130 Cariacica";269;113;3;463;1;979;1828
"320140 Castelo";23;6;0;28;0;31;88
"320150 Colatina";95;28;1;100;0;167;391
"320160 Conceição da Barra";3;6;1;27;0;31;68
"320170 Conceição do Castelo";0;0;0;4;0;7;11
"320180 Divino de São Lourenço";1;0;0;0;0;1;2
"320190 Domingos Martins";3;0;0;5;0;21;29
"320200 Dores do Rio Preto";4;0;0;2;0;1;7
"320210 Ecoporanga";5;1;0;8;0;18;32
"320220 Fundão";7;4;0;16;0;22;49
"320225 Governador Lindenberg";2;0;0;4;0;3;9
"320230 Guaçuí";18;13;1;8;0;18;58
"320240 Guarapari";83;35;0;92;0;284;494
"320245 Ibatiba";5;0;0;8;0;13;26
"320250 Ibiraçu";5;1;0;5;0;14;25
"320255 Ibitirama";2;4;0;0;0;1;7
"320260 Iconha";13;1;0;9;0;15;38
"320265 Irupi";3;0;0;4;0;2;9
"320270 Itaguaçu";3;2;0;4;0;3;12
"320280 Itapemirim";36;11;0;34;0;42;123
"320290 Itarana";3;0;0;2;0;4;9
"320300 Iúna";9;1;0;11;0;16;37
"320305 Jaguaré";4;3;4;10;0;25;46
"320310 Jerônimo Monteiro";8;1;0;9;0;11;29
"320313 João Neiva";11;1;0;6;0;14;32
"320316 Laranja da Terra";3;0;0;0;0;2;5
"320320 Linhares";133;31;3;156;0;174;497
"320330 Mantenópolis";2;1;0;2;0;5;10
"320332 Marataízes";34;9;0;39;0;29;111
"320334 Marechal Floriano";4;1;0;2;0;9;16
"320335 Marilândia";2;0;0;1;0;5;8
"320340 Mimoso do Sul";13;3;0;16;0;14;46
"320350 Montanha";1;1;3;26;0;30;61
"320360 Mucurici";1;0;0;2;0;7;10
"320370 Muniz Freire";3;3;0;2;0;5;13
"320380 Muqui";10;6;0;12;0;4;32
"320390 Nova Venécia";15;3;1;22;0;22;63
"320400 Pancas";6;1;0;3;0;8;18
"320405 Pedro Canário";6;3;3;13;0;37;62
"320410 Pinheiros";9;5;5;16;0;19;54
"320420 Piúma";15;3;0;21;0;48;87
"320425 Ponto Belo";2;1;2;5;0;7;17
"320430 Presidente Kennedy";13;0;0;8;0;12;33
"320435 Rio Bananal";9;11;0;11;0;14;45
"320440 Rio Novo do Sul";8;1;2;8;0;4;23
"320450 Santa Leopoldina";3;0;0;3;0;7;13
"320455 Santa Maria de Jetibá";4;0;0;5;0;19;28
"320460 Santa Teresa";4;3;0;0;0;6;13
"320465 São Domingos do Norte";2;0;0;6;0;5;13
"320470 São Gabriel da Palha";17;1;0;8;0;20;46
"320480 São José do Calçado";8;5;0;8;0;15;36
"320490 São Mateus";56;27;18;104;1;148;354
"320495 São Roque do Canaã";1;0;0;1;0;3;5
"320500 Serra";335;127;2;641;2;958;2065
"320501 Sooretama";7;7;0;15;0;17;46
"320503 Vargem Alta";9;3;0;7;0;3;22
"320506 Venda Nova do Imigrante";5;0;0;0;0;9;14
"320510 Viana";45;11;1;79;0;173;309
"320515 Vila Pavão";2;2;0;6;0;5;15
"320517 Vila Valério";3;3;0;9;0;8;23
"320520 Vila Velha";408;123;1;575;2;1233;2342
"320530 Vitória";485;187;5;609;1;1382;2669
"320000 Município ignorado - ES";1;0;0;0;0;0;1
"330010 Angra dos Reis";134;28;0;44;0;471;677
"330015 Aperibé";3;2;0;1;0;3;9
"330020 Araruama";92;24;0;45;1;236;398
"330022 Areal";8;9;0;5;0;25;47
"330023 Armação dos Búzios";61;7;0;26;0;65;159
"330025 Arraial do Cabo";15;6;0;15;0;62;98
"330030 Barra do Piraí";52;34;0;24;0;132;242
"330040 Barra Mansa";279;71;3;82;0;347;782
"330045 Belford Roxo";261;152;6;384;5;2113;2921
"330050 Bom Jardim";12;2;0;1;0;26;41
"330060 Bom Jesus do Itabapoana";41;17;3;15;0;80;156
"330070 Cabo Frio";173;48;3;93;1;542;860
"330080 Cachoeiras de Macacu";19;12;0;17;0;78;126
"330090 Cambuci";5;3;0;3;0;7;18
"330100 Campos dos Goytacazes";381;220;4;173;0;1444;2222
"330110 Cantagalo";1;3;0;6;0;14;24
"330093 Carapebus";4;1;0;5;0;12;22
"330115 Cardoso Moreira";6;1;0;1;0;15;23
"330120 Carmo";19;13;0;3;0;16;51
"330130 Casimiro de Abreu";24;7;1;18;0;46;96
"330095 Comendador Levy Gasparian";6;3;0;1;0;9;19
"330140 Conceição de Macabu";11;1;0;5;0;23;40
"330150 Cordeiro";4;3;0;1;0;57;65
"330160 Duas Barras";6;3;0;0;0;11;20
"330170 Duque de Caxias";650;434;16;818;0;3804;5722
"330180 Engenheiro Paulo de Frontin";10;3;0;3;0;22;38
"330185 Guapimirim";28;18;1;34;2;104;187
"330187 Iguaba Grande";21;5;0;17;0;43;86
"330190 Itaboraí";130;73;1;170;2;807;1183
"330200 Itaguaí";107;34;1;110;1;270;523
"330205 Italva";10;0;0;2;0;8;20
"330210 Itaocara";5;2;0;4;0;28;39
"330220 Itaperuna";99;31;4;52;0;181;367
"330225 Itatiaia";18;5;0;2;0;48;73
"330227 Japeri";66;74;2;94;0;415;651
"330230 Laje do Muriaé";2;6;0;1;0;4;13
"330240 Macaé";231;106;4;160;1;850;1352
"330245 Macuco";1;4;0;2;0;13;20
"330250 Magé";241;134;13;227;4;742;1361
"330260 Mangaratiba";37;13;2;26;0;94;172
"330270 Maricá";76;20;0;55;0;395;546
"330280 Mendes";10;7;1;5;0;39;62
"330285 Mesquita";119;82;2;163;0;421;787
"330290 Miguel Pereira";23;10;0;14;0;61;108
"330300 Miracema";35;27;0;5;0;74;141
"330310 Natividade";24;14;0;8;1;44;91
"330320 Nilópolis";128;86;6;117;0;624;961
"330330 Niterói";892;379;7;512;1;3085;4876
"330340 Nova Friburgo";146;31;0;23;1;510;711
"330350 Nova Iguaçu";611;446;12;821;4;4407;6301
"330360 Paracambi";39;21;1;39;0;178;278
"330370 Paraíba do Sul";30;31;0;9;0;109;179
"330380 Parati";49;5;0;5;0;66;125
"330385 Paty do Alferes";8;3;0;2;0;40;53
"330390 Petrópolis";489;97;1;142;2;778;1509
"330395 Pinheiral";11;6;0;5;0;20;42
"330400 Piraí";19;8;0;19;0;62;108
"330410 Porciúncula";22;22;0;18;0;37;99
"330411 Porto Real";5;5;0;5;0;19;34
"330412 Quatis";6;5;0;3;0;13;27
"330414 Queimados";81;85;3;120;1;664;954
"330415 Quissamã";8;4;0;4;0;42;58
"330420 Resende";93;25;0;25;0;210;353
"330430 Rio Bonito";17;11;0;14;0;101;143
"330440 Rio Claro";5;1;1;1;0;10;18
"330450 Rio das Flores";1;1;0;1;0;8;11
"330452 Rio das Ostras";104;46;0;73;1;267;491
"330455 Rio de Janeiro";9179;3758;57;6017;37;42952;62000
"330460 Santa Maria Madalena";2;1;0;0;0;6;9
"330470 Santo Antônio de Pádua";21;11;0;6;0;71;109
"330480 São Fidélis";8;3;0;1;0;45;57
"330475 São Francisco de Itabapoana";18;1;0;8;0;38;65
"330490 São Gonçalo";703;341;7;456;2;3597;5106
"330500 São João da Barra";20;4;0;8;0;49;81
"330510 São João de Meriti";446;303;6;530;3;1921;3209
"330513 São José de Ubá";2;0;0;1;0;4;7
"330515 São José do Vale do Rio Preto";13;3;0;8;0;15;39
"330520 São Pedro da Aldeia";27;4;0;35;0;155;221
"330530 São Sebastião do Alto";1;0;0;0;0;4;5
"330540 Sapucaia";11;9;0;8;0;34;62
"330550 Saquarema";68;19;1;43;0;184;315
"330555 Seropédica";42;13;1;31;0;136;223
"330560 Silva Jardim";4;5;0;7;0;27;43
"330570 Sumidouro";5;4;0;3;0;18;30
"330575 Tanguá";11;6;0;11;0;51;79
"330580 Teresópolis";162;38;0;35;0;441;676
"330590 Trajano de Morais";3;2;0;1;0;6;12
"330600 Três Rios";77;41;1;36;0;333;488
"330610 Valença";23;18;1;13;0;133;188
"330615 Varre-Sai";5;0;0;2;0;5;12
"330620 Vassouras";44;27;0;12;0;69;152
"330630 Volta Redonda";282;60;6;100;0;733;1181
"330000 Município ignorado - RJ";4;5;0;5;0;106;120
"350010 Adamantina";26;2;0;4;0;33;65
"350020 Adolfo";8;0;0;1;0;3;12
"350030 Aguaí";23;5;0;4;0;38;70
"350040 Águas da Prata";8;0;0;4;0;11;23
"350050 Águas de Lindóia";19;0;0;3;0;19;41
"350055 Águas de Santa Bárbara";1;0;0;1;0;3;5
"350060 Águas de São Pedro";3;0;0;1;0;6;10
"350070 Agudos";29;6;0;10;0;82;127
"350075 Alambari";2;0;0;0;0;4;6
"350080 Alfredo Marcondes";1;1;0;1;0;3;6
"350090 Altair";5;0;0;3;0;5;13
"350100 Altinópolis";17;2;0;7;0;17;43
"350110 Alto Alegre";3;0;0;1;0;1;5
"350115 Alumínio";9;0;0;2;0;19;30
"350120 Álvares Florence";12;0;0;0;0;5;17
"350130 Álvares Machado";22;1;0;17;0;42;82
"350140 Álvaro de Carvalho";13;6;0;7;0;22;48
"350150 Alvinlândia";2;1;0;0;0;4;7
"350160 Americana";417;31;1;104;0;549;1102
"350170 Américo Brasiliense";26;6;0;9;0;95;136
"350180 Américo de Campos";7;0;0;2;0;7;16
"350190 Amparo";114;10;0;13;0;183;320
"350200 Analândia";4;0;0;0;0;2;6
"350210 Andradina";81;20;0;60;0;162;323
"350220 Angatuba";12;0;0;0;0;24;36
"350230 Anhembi";5;1;0;0;0;8;14
"350240 Anhumas";3;1;0;2;0;4;10
"350250 Aparecida";73;7;0;22;0;159;261
"350260 Aparecida d'Oeste";2;0;0;2;0;4;8
"350270 Apiaí";13;1;0;3;0;26;43
"350275 Araçariguama";15;0;0;8;0;23;46
"350280 Araçatuba";406;45;7;186;1;734;1379
"350290 Araçoiaba da Serra";11;2;0;3;0;39;55
"350300 Aramina";3;0;0;0;0;1;4
"350310 Arandu";4;2;0;1;0;4;11
"350315 Arapeí";1;0;0;0;0;0;1
"350320 Araraquara";382;60;3;151;5;1154;1755
"350330 Araras";215;28;1;66;0;475;785
"350335 Arco-Íris";0;0;0;2;0;1;3
"350340 Arealva";3;0;0;1;0;9;13
"350350 Areias";4;1;0;0;0;0;5
"350360 Areiópolis";6;3;0;1;0;4;14
"350370 Ariranha";11;0;0;3;0;12;26
"350380 Artur Nogueira";33;4;0;9;0;30;76
"350390 Arujá";42;13;1;18;0;149;223
"350395 Aspásia";2;0;0;0;0;1;3
"350400 Assis";164;16;2;31;0;290;503
"350410 Atibaia";98;9;0;27;1;379;514
"350420 Auriflama";3;0;0;3;0;3;9
"350430 Avaí";7;1;0;4;0;15;27
"350440 Avanhandava";13;2;0;4;0;18;37
"350450 Avaré";107;8;0;28;0;247;390
"350460 Bady Bassitt";16;3;0;1;0;26;46
"350470 Balbinos";22;5;0;9;0;13;49
"350480 Bálsamo";8;1;0;1;0;11;21
"350490 Bananal";6;4;0;4;0;12;26
"350500 Barão de Antonina";0;0;0;0;0;1;1
"350510 Barbosa";6;0;0;2;0;13;21
"350520 Bariri";28;2;0;3;0;37;70
"350530 Barra Bonita";35;2;0;11;0;66;114
"350535 Barra do Chapéu";2;0;0;0;0;0;2
"350540 Barra do Turvo";8;1;0;1;0;6;16
"350550 Barretos";396;69;4;168;0;830;1467
"350560 Barrinha";27;5;0;9;1;72;114
"350570 Barueri";283;37;4;143;0;513;980
"350580 Bastos";13;2;0;8;0;5;28
"350590 Batatais";74;9;0;11;2;184;280
"350600 Bauru";606;94;6;209;2;1836;2753
"350610 Bebedouro";236;50;1;55;0;580;922
"350620 Bento de Abreu";2;1;0;3;0;2;8
"350630 Bernardino de Campos";5;2;0;1;0;13;21
"350635 Bertioga";35;2;0;23;0;116;176
"350640 Bilac";5;0;0;1;0;5;11
"350650 Birigui";183;18;3;28;0;240;472
"350660 Biritiba-Mirim";13;2;1;3;0;25;44
"350670 Boa Esperança do Sul";14;4;1;4;0;25;48
"350680 Bocaina";14;2;1;2;0;17;36
"350690 Bofete";13;2;0;1;0;8;24
"350700 Boituva";26;1;0;4;0;68;99
"350710 Bom Jesus dos Perdões";9;0;0;1;0;17;27
"350715 Bom Sucesso de Itararé";3;0;0;0;0;1;4
"350720 Borá";0;0;0;0;0;2;2
"350730 Boracéia";3;2;0;1;0;3;9
"350740 Borborema";12;0;0;0;0;20;32
"350745 Borebi";2;0;0;0;0;2;4
"350750 Botucatu";239;27;1;27;0;290;584
"350760 Bragança Paulista";225;20;0;53;0;339;637
"350770 Braúna";4;0;0;1;0;0;5
"350775 Brejo Alegre";1;1;0;0;0;3;5
"350780 Brodowski";37;3;0;3;0;33;76
"350790 Brotas";36;4;0;10;0;36;86
"350800 Buri";9;0;0;0;0;8;17
"350810 Buritama";22;3;0;0;0;31;56
"350820 Buritizal";2;0;0;2;0;2;6
"350830 Cabrália Paulista";6;1;0;2;0;9;18
"350840 Cabreúva";22;2;0;4;0;50;78
"350850 Caçapava";181;23;0;93;0;602;899
"350860 Cachoeira Paulista";31;4;0;7;0;64;106
"350870 Caconde";1;0;0;0;0;13;14
"350880 Cafelândia";11;1;0;4;0;15;31
"350890 Caiabu";4;0;0;0;0;0;4
"350900 Caieiras";54;10;2;30;0;132;228
"350910 Caiuá";3;0;0;1;0;5;9
"350920 Cajamar";53;4;0;30;0;122;209
"350925 Cajati";42;3;0;22;1;72;140
"350930 Cajobi";1;1;0;3;0;8;13
"350940 Cajuru";40;4;0;9;0;35;88
"350945 Campina do Monte Alegre";1;0;0;0;0;9;10
"350950 Campinas";2175;391;16;964;3;4591;8140
"350960 Campo Limpo Paulista";52;2;1;16;1;215;287
"350970 Campos do Jordão";100;8;1;15;0;126;250
"350980 Campos Novos Paulista";1;0;0;2;0;5;8
"350990 Cananéia";16;0;0;7;0;34;57
"350995 Canas";1;0;0;2;0;3;6
"351000 Cândido Mota";21;2;0;3;0;34;60
"351010 Cândido Rodrigues";2;0;0;0;0;8;10
"351015 Canitar";3;0;0;1;0;4;8
"351020 Capão Bonito";31;3;0;7;0;53;94
"351030 Capela do Alto";8;3;0;2;0;32;45
"351040 Capivari";80;36;0;35;0;205;356
"351050 Caraguatatuba";289;26;1;138;0;294;748
"351060 Carapicuíba";404;94;0;211;0;1038;1747
"351070 Cardoso";19;2;0;11;0;16;48
"351080 Casa Branca";40;5;1;22;1;61;130
"351090 Cássia dos Coqueiros";1;0;0;2;0;1;4
"351100 Castilho";13;2;0;11;0;16;42
"351110 Catanduva";324;35;1;81;0;768;1209
"351120 Catiguá";6;2;0;2;0;12;22
"351130 Cedral";8;1;0;1;0;6;16
"351140 Cerqueira César";20;1;0;4;0;18;43
"351150 Cerquilho";29;1;0;10;0;55;95
"351160 Cesário Lange";9;2;0;2;0;11;24
"351170 Charqueada";11;1;0;1;0;10;23
"355720 Chavantes";5;0;0;2;0;11;18
"351190 Clementina";3;1;0;1;0;6;11
"351200 Colina";27;3;0;15;0;33;78
"351210 Colômbia";16;3;0;3;0;17;39
"351220 Conchal";22;1;0;5;0;20;48
"351230 Conchas";32;2;0;2;0;33;69
"351240 Cordeirópolis";17;0;0;6;0;21;44
"351250 Coroados";2;0;0;2;0;6;10
"351260 Coronel Macedo";3;0;0;0;0;2;5
"351270 Corumbataí";2;0;0;1;0;5;8
"351280 Cosmópolis";102;16;0;28;0;129;275
"351290 Cosmorama";7;0;0;4;0;4;15
"351300 Cotia";201;17;3;84;0;350;655
"351310 Cravinhos";50;3;0;13;0;70;136
"351320 Cristais Paulista";5;0;0;0;0;14;19
"351330 Cruzália";0;0;0;0;0;1;1
"351340 Cruzeiro";210;43;0;78;0;380;711
"351350 Cubatão";108;31;0;142;1;723;1005
"351360 Cunha";5;2;0;3;0;10;20
"351370 Descalvado";35;3;0;2;0;52;92
"351380 Diadema";457;104;4;329;0;1035;1929
"351385 Dirce Reis";0;0;0;0;0;2;2
"351390 Divinolândia";1;0;0;0;0;2;3
"351400 Dobrada";7;0;0;0;0;4;11
"351410 Dois Córregos";26;4;0;7;0;37;74
"351420 Dolcinópolis";3;1;0;1;0;3;8
"351430 Dourado";5;0;0;2;0;15;22
"351440 Dracena";50;4;0;15;0;61;130
"351450 Duartina";7;0;0;2;0;26;35
"351460 Dumont";11;1;0;5;0;7;24
"351470 Echaporã";4;0;0;3;0;4;11
"351480 Eldorado";8;0;0;2;0;10;20
"351490 Elias Fausto";16;1;0;5;0;22;44
"351492 Elisiário";1;0;0;0;0;4;5
"351495 Embaúba";2;0;0;0;0;2;4
"351500 Embu";157;45;2;125;1;489;819
"351510 Embu-Guaçu";35;4;0;19;1;109;168
"351512 Emilianópolis";2;0;0;3;0;1;6
"351515 Engenheiro Coelho";7;0;0;4;0;14;25
"351518 Espírito Santo do Pinhal";36;4;0;6;0;42;88
"351519 Espírito Santo do Turvo";1;1;0;0;0;0;2
"355730 Estiva Gerbi";4;2;0;0;0;10;16
"351520 Estrela d'Oeste";3;0;0;0;0;5;8
"351530 Estrela do Norte";2;0;0;0;0;1;3
"351535 Euclides da Cunha Paulista";2;0;0;3;0;3;8
"351540 Fartura";18;0;0;1;0;12;31
"351560 Fernando Prestes";17;1;0;5;0;11;34
"351550 Fernandópolis";77;3;1;14;0;182;277
"351565 Fernão";0;0;0;0;0;1;1
"351570 Ferraz de Vasconcelos";137;46;0;115;0;384;682
"351580 Flora Rica";0;0;0;0;0;4;4
"351590 Floreal";3;0;1;0;0;2;6
"351600 Flórida Paulista";18;3;0;9;0;16;46
"351610 Florínia";1;0;0;0;0;1;2
"351620 Franca";369;72;3;116;1;1107;1668
"351630 Francisco Morato";111;34;1;91;1;443;681
"351640 Franco da Rocha";166;36;0;116;0;453;771
"351650 Gabriel Monteiro";1;0;0;1;0;0;2
"351660 Gália";8;0;0;3;0;21;32
"351670 Garça";27;6;0;9;0;71;113
"351680 Gastão Vidigal";2;0;0;0;0;1;3
"351685 Gavião Peixoto";3;0;0;0;0;1;4
"351690 General Salgado";15;1;0;2;0;12;30
"351700 Getulina";25;5;1;11;0;37;79
"351710 Glicério";4;0;0;1;0;1;6
"351720 Guaiçara";14;0;0;2;0;24;40
"351730 Guaimbê";4;1;0;1;0;4;10
"351740 Guaíra";31;7;0;25;0;42;105
"351750 Guapiaçu";34;4;0;3;0;33;74
"351760 Guapiara";10;0;1;4;0;11;26
"351770 Guará";10;5;0;4;0;42;61
"351780 Guaraçaí";12;1;1;4;0;12;30
"351790 Guaraci";2;5;0;7;0;20;34
"351800 Guarani d'Oeste";4;0;0;1;0;4;9
"351810 Guarantã";3;0;0;1;0;2;6
"351820 Guararapes";25;4;1;13;0;38;81
"351830 Guararema";12;1;0;6;0;39;58
"351840 Guaratinguetá";216;24;1;42;0;363;646
"351850 Guareí";13;2;0;18;0;37;70
"351860 Guariba";21;5;0;11;1;69;107
"351870 Guarujá";214;33;4;265;0;1763;2279
"351880 Guarulhos";1136;173;14;547;3;3834;5707
"351885 Guatapará";6;2;0;1;1;12;22
"351890 Guzolândia";3;0;0;8;0;3;14
"351900 Herculândia";6;0;0;1;0;10;17
"351905 Holambra";12;0;0;2;0;6;20
"351907 Hortolândia";309;51;5;155;0;430;950
"351910 Iacanga";6;0;0;5;0;14;25
"351920 Iacri";3;0;0;1;0;5;9
"351925 Iaras";32;8;0;12;0;16;68
"351930 Ibaté";30;5;0;11;0;41;87
"351940 Ibirá";8;1;0;3;0;19;31
"351950 Ibirarema";3;0;0;0;0;8;11
"351960 Ibitinga";71;7;0;12;0;72;162
"351970 Ibiúna";23;1;0;4;0;66;94
"351980 Icém";13;2;0;1;0;7;23
"351990 Iepê";6;0;0;5;0;4;15
"352000 Igaraçu do Tietê";17;5;0;4;0;37;63
"352010 Igarapava";19;1;0;3;0;47;70
"352020 Igaratá";6;1;0;4;0;9;20
"352030 Iguape";32;2;0;14;0;54;102
"352042 Ilha Comprida";16;2;0;4;0;22;44
"352044 Ilha Solteira";23;4;0;11;0;39;77
"352040 Ilhabela";38;3;0;19;0;43;103
"352050 Indaiatuba";230;21;2;34;0;275;562
"352060 Indiana";4;0;0;3;0;4;11
"352070 Indiaporã";2;0;0;0;0;5;7
"352080 Inúbia Paulista";4;0;0;2;0;3;9
"352090 Ipaussu";5;0;0;3;0;25;33
"352100 Iperó";21;5;0;8;0;58;92
"352110 Ipeúna";4;0;0;0;0;1;5
"352115 Ipiguá";4;1;0;0;0;7;12
"352120 Iporanga";1;0;1;2;0;4;8
"352130 Ipuã";6;4;0;2;0;12;24
"352140 Iracemápolis";17;1;0;6;0;18;42
"352150 Irapuã";4;0;0;0;0;7;11
"352160 Irapuru";15;2;0;6;0;8;31
"352170 Itaberá";11;0;0;3;0;15;29
"352180 Itaí";49;13;1;13;0;74;150
"352190 Itajobi";22;0;0;2;0;12;36
"352200 Itaju";0;1;0;0;0;1;2
"352210 Itanhaém";170;15;1;70;0;272;528
"352215 Itaóca";0;0;0;2;0;3;5
"352220 Itapecerica da Serra";88;15;4;65;0;256;428
"352230 Itapetininga";161;14;1;22;1;503;702
"352240 Itapeva";111;1;1;10;0;97;220
"352250 Itapevi";189;43;2;126;0;641;1001
"352260 Itapira";169;17;0;17;0;316;519
"352265 Itapirapuã Paulista";1;0;0;0;0;0;1
"352270 Itápolis";44;5;0;6;0;55;110
"352280 Itaporanga";16;5;0;6;0;22;49
"352290 Itapuí";8;1;0;1;0;8;18
"352300 Itapura";5;0;0;2;0;7;14
"352310 Itaquaquecetuba";254;57;1;181;1;640;1134
"352320 Itararé";84;7;0;11;0;76;178
"352330 Itariri";2;0;0;2;0;18;22
"352340 Itatiba";139;24;3;29;1;170;366
"352350 Itatinga";20;5;0;1;0;10;36
"352360 Itirapina";33;8;0;18;1;62;122
"352370 Itirapuã";1;0;0;1;0;3;5
"352380 Itobi";1;0;0;0;0;6;7
"352390 Itu";326;40;0;107;1;495;969
"352400 Itupeva";26;2;0;5;1;56;90
"352410 Ituverava";61;11;0;18;0;98;188
"352420 Jaborandi";8;1;0;1;0;6;16
"352430 Jaboticabal";122;11;2;25;1;388;549
"352440 Jacareí";466;43;2;149;1;910;1571
"352450 Jaci";13;2;0;1;0;10;26
"352460 Jacupiranga";23;3;0;1;0;42;69
"352470 Jaguariúna";59;3;0;11;0;80;153
"352480 Jales";47;1;1;9;0;80;138
"352490 Jambeiro";3;0;0;2;0;7;12
"352500 Jandira";96;20;0;42;1;209;368
"352510 Jardinópolis";57;10;0;15;1;109;192
"352520 Jarinu";12;2;0;4;0;40;58
"352530 Jaú";171;24;0;38;1;259;493
"352540 Jeriquara";0;0;0;1;1;7;9
"352550 Joanópolis";3;0;0;0;0;9;12
"352560 João Ramalho";5;2;0;1;0;2;10
"352570 José Bonifácio";57;4;0;7;0;79;147
"352580 Júlio Mesquita";3;0;0;3;0;2;8
"352590 Jundiaí";414;41;2;74;2;1617;2150
"352600 Junqueirópolis";22;5;0;14;0;24;65
"352610 Juquiá";15;0;0;8;0;33;56
"352620 Juquitiba";15;2;0;8;0;43;68
"352630 Lagoinha";2;0;0;0;0;17;19
"352640 Laranjal Paulista";30;2;1;7;0;41;81
"352650 Lavínia";8;3;0;8;0;16;35
"352660 Lavrinhas";7;2;0;3;0;9;21
"352670 Leme";151;10;0;21;0;262;444
"352680 Lençóis Paulista";58;2;0;20;0;134;214
"352690 Limeira";425;66;1;72;0;779;1343
"352700 Lindóia";4;0;0;0;0;3;7
"352710 Lins";90;19;1;53;0;230;393
"352720 Lorena";111;8;3;15;0;330;467
"352725 Lourdes";1;0;0;0;0;0;1
"352730 Louveira";15;2;0;5;0;30;52
"352740 Lucélia";38;5;0;20;0;48;111
"352750 Lucianópolis";3;0;0;2;0;4;9
"352760 Luís Antônio";6;4;0;2;0;9;21
"352770 Luiziânia";2;0;0;2;0;2;6
"352780 Lupércio";2;0;0;1;0;0;3
"352790 Lutécia";1;0;0;1;0;5;7
"352800 Macatuba";2;1;0;2;0;5;10
"352810 Macaubal";5;0;0;4;0;11;20
"352820 Macedônia";0;1;0;0;0;1;2
"352830 Magda";8;1;0;0;0;0;9
"352840 Mairinque";26;9;0;12;0;73;120
"352850 Mairiporã";61;8;0;22;0;198;289
"352860 Manduri";6;0;0;2;0;16;24
"352870 Marabá Paulista";3;1;0;5;0;8;17
"352880 Maracaí";5;0;0;1;0;13;19
"352885 Marapoama";1;0;0;0;0;1;2
"352890 Mariápolis";3;0;0;0;0;0;3
"352900 Marília";356;57;4;160;0;713;1290
"352920 Martinópolis";58;7;0;17;0;52;134
"352930 Matão";119;7;1;28;0;160;315
"352940 Mauá";352;55;4;179;1;1210;1801
"352950 Mendonça";11;0;0;1;0;8;20
"352960 Meridiano";8;0;0;1;0;7;16
"352970 Miguelópolis";19;4;0;8;0;53;84
"352980 Mineiros do Tietê";3;0;0;4;0;14;21
"353000 Mira Estrela";1;0;0;0;0;4;5
"352990 Miracatu";34;3;0;8;0;39;84
"353010 Mirandópolis";35;10;0;32;0;150;227
"353020 Mirante do Paranapanema";8;0;0;8;0;20;36
"353030 Mirassol";134;19;0;16;0;251;420
"353040 Mirassolândia";5;2;0;0;0;15;22
"353050 Mococa";79;10;0;21;1;175;286
"353060 Mogi das Cruzes";383;54;7;179;1;708;1332
"353070 Mogi Guaçu";202;14;0;26;1;258;501
"353080 Moji Mirim";182;25;0;33;0;305;545
"353090 Mombuca";6;0;0;3;0;5;14
"353100 Monções";2;0;0;0;0;4;6
"353110 Mongaguá";49;12;2;20;0;165;248
"353120 Monte Alegre do Sul";2;1;0;1;0;7;11
"353130 Monte Alto";95;12;0;8;0;213;328
"353140 Monte Aprazível";35;8;1;1;0;48;93
"353150 Monte Azul Paulista";21;5;0;11;0;47;84
"353160 Monte Castelo";2;0;0;0;0;1;3
"353180 Monte Mor";60;7;0;22;0;89;178
"353170 Monteiro Lobato";3;0;0;0;0;5;8
"353190 Morro Agudo";8;2;0;6;0;30;46
"353200 Morungaba";9;1;0;1;0;2;13
"353205 Motuca";2;0;0;0;0;4;6
"353210 Murutinga do Sul";3;0;0;2;0;4;9
"353215 Nantes";4;1;0;0;0;2;7
"353220 Narandiba";8;0;0;3;0;5;16
"353230 Natividade da Serra";5;0;0;0;0;4;9
"353240 Nazaré Paulista";2;0;0;1;0;22;25
"353250 Neves Paulista";16;2;0;1;0;21;40
"353260 Nhandeara";16;2;0;4;0;8;30
"353270 Nipoã";5;0;0;0;0;4;9
"353280 Nova Aliança";10;1;0;1;0;9;21
"353282 Nova Campina";3;1;0;1;0;3;8
"353284 Nova Canaã Paulista";1;0;0;0;0;0;1
"353286 Nova Castilho";0;0;0;2;0;0;2
"353290 Nova Europa";14;2;0;3;0;24;43
"353300 Nova Granada";15;2;0;2;0;18;37
"353310 Nova Guataporanga";3;0;0;1;0;5;9
"353320 Nova Independência";2;0;0;0;0;4;6
"353330 Nova Luzitânia";3;0;0;2;0;1;6
"353340 Nova Odessa";63;6;0;15;0;77;161
"353325 Novais";4;1;0;0;0;7;12
"353350 Novo Horizonte";28;2;0;11;0;36;77
"353360 Nuporanga";4;0;0;3;0;10;17
"353370 Ocauçu";1;1;0;2;0;3;7
"353380 Óleo";0;0;0;0;0;1;1
"353390 Olímpia";53;13;0;16;0;113;195
"353400 Onda Verde";7;1;0;0;0;10;18
"353410 Oriente";3;0;0;0;0;9;12
"353420 Orindiúva";6;1;0;0;0;5;12
"353430 Orlândia";23;2;0;6;0;65;96
"353440 Osasco";661;106;8;378;1;2633;3787
"353450 Oscar Bressane";1;0;0;0;0;2;3
"353460 Osvaldo Cruz";39;1;1;15;0;49;105
"353470 Ourinhos";130;21;1;54;0;360;566
"353480 Ouro Verde";6;0;0;0;0;1;7
"353475 Ouroeste";6;0;0;1;0;10;17
"353490 Pacaembu";31;10;0;23;1;48;113
"353500 Palestina";7;2;0;2;0;18;29
"353510 Palmares Paulista";17;3;0;2;0;24;46
"353520 Palmeira d'Oeste";2;1;0;2;0;7;12
"353530 Palmital";19;0;0;3;0;21;43
"353540 Panorama";10;0;0;9;0;15;34
"353550 Paraguaçu Paulista";34;3;0;14;1;118;170
"353560 Paraibuna";8;1;0;1;0;12;22
"353570 Paraíso";8;0;0;0;0;5;13
"353580 Paranapanema";10;2;0;1;0;12;25
"353590 Paranapuã";2;0;0;1;0;6;9
"353600 Parapuã";8;0;0;7;0;12;27
"353610 Pardinho";12;2;0;1;0;2;17
"353620 Pariquera-Açu";30;1;0;5;0;43;79
"353625 Parisi";5;0;1;1;0;4;11
"353630 Patrocínio Paulista";1;1;0;2;0;6;10
"353640 Paulicéia";5;0;0;1;0;6;12
"353650 Paulínia";69;3;0;41;1;245;359
"353657 Paulistânia";2;0;0;0;0;3;5
"353660 Paulo de Faria";12;4;0;5;0;24;45
"353670 Pederneiras";30;5;0;5;0;99;139
"353680 Pedra Bela";7;0;0;0;0;2;9
"353690 Pedranópolis";2;0;0;0;0;4;6
"353700 Pedregulho";8;2;0;3;0;26;39
"353710 Pedreira";50;3;0;4;0;38;95
"353715 Pedrinhas Paulista";0;0;0;0;0;3;3
"353720 Pedro de Toledo";8;0;0;1;0;22;31
"353730 Penápolis";55;6;1;11;0;108;181
"353740 Pereira Barreto";47;7;1;50;0;72;177
"353750 Pereiras";6;1;0;0;0;10;17
"353760 Peruíbe";80;7;1;40;0;208;336
"353770 Piacatu";3;0;0;3;0;3;9
"353780 Piedade";31;1;1;4;0;106;143
"353790 Pilar do Sul";9;0;0;1;0;21;31
"353800 Pindamonhangaba";146;30;2;163;0;235;576
"353810 Pindorama";26;2;0;3;0;37;68
"353820 Pinhalzinho";14;0;0;0;0;18;32
"353830 Piquerobi";0;1;0;1;0;5;7
"353850 Piquete";8;4;0;1;0;31;44
"353860 Piracaia";6;3;0;0;0;25;34
"353870 Piracicaba";626;123;1;252;0;1417;2419
"353880 Piraju";20;1;0;3;0;36;60
"353890 Pirajuí";44;3;0;10;0;148;205
"353900 Pirangi";21;0;0;5;0;13;39
"353910 Pirapora do Bom Jesus";14;3;0;10;0;33;60
"353920 Pirapozinho";27;1;0;8;0;28;64
"353930 Pirassununga";82;12;0;12;0;190;296
"353940 Piratininga";11;2;0;1;0;19;33
"353950 Pitangueiras";34;9;0;12;2;46;103
"353960 Planalto";2;0;0;0;0;5;7
"353970 Platina";3;1;0;2;0;7;13
"353980 Poá";107;15;1;45;2;259;429
"353990 Poloni";11;1;0;0;0;6;18
"354000 Pompéia";25;4;0;16;0;27;72
"354010 Pongaí";2;0;0;1;0;3;6
"354020 Pontal";21;4;0;7;0;53;85
"354025 Pontalinda";4;1;0;1;0;3;9
"354030 Pontes Gestal";4;0;0;0;0;2;6
"354040 Populina";5;0;1;2;0;4;12
"354050 Porangaba";10;0;0;1;0;3;14
"354060 Porto Feliz";27;1;0;4;0;65;97
"354070 Porto Ferreira";58;10;0;9;0;128;205
"354075 Potim";29;2;0;19;0;71;121
"354080 Potirendaba";16;2;1;0;0;28;47
"354085 Pracinha";8;1;0;4;0;10;23
"354090 Pradópolis";8;3;0;1;0;8;20
"354100 Praia Grande";357;58;3;258;1;1034;1711
"354105 Pratânia";3;1;0;1;0;2;7
"354110 Presidente Alves";0;0;0;0;0;1;1
"354120 Presidente Bernardes";29;2;1;7;0;56;95
"354130 Presidente Epitácio";57;8;0;50;0;59;174
"354140 Presidente Prudente";450;47;9;210;1;729;1446
"354150 Presidente Venceslau";33;2;3;23;0;105;166
"354160 Promissão";20;4;1;9;0;56;90
"354165 Quadra";1;0;0;1;0;3;5
"354170 Quatá";11;4;0;6;0;11;32
"354180 Queiroz";1;1;0;4;0;5;11
"354190 Queluz";8;3;0;4;0;13;28
"354200 Quintana";5;1;0;6;0;6;18
"354210 Rafard";9;4;0;6;0;28;47
"354220 Rancharia";39;4;0;16;0;27;86
"354230 Redenção da Serra";0;0;0;0;0;2;2
"354240 Regente Feijó";18;4;0;8;0;17;47
"354250 Reginópolis";18;2;0;8;0;7;35
"354260 Registro";61;3;2;25;0;94;185
"354270 Restinga";6;0;0;2;0;5;13
"354280 Ribeira";0;1;0;0;0;2;3
"354290 Ribeirão Bonito";7;0;0;3;0;11;21
"354300 Ribeirão Branco";2;0;0;1;0;4;7
"354310 Ribeirão Corrente";2;1;0;1;0;2;6
"354320 Ribeirão do Sul";1;0;0;1;0;3;5
"354330 Ribeirão Pires";107;11;1;48;0;233;400
"354340 Ribeirão Preto";1523;298;8;407;12;4773;7021
"354360 Rifaina";0;1;0;2;0;6;9
"354370 Rincão";3;2;0;3;0;23;31
"354380 Rinópolis";6;1;0;2;0;11;20
"354390 Rio Claro";353;69;1;75;0;613;1111
"354400 Rio das Pedras";18;1;0;12;0;27;58
"354410 Rio Grande da Serra";37;4;0;22;0;70;133
"354420 Riolândia";27;1;0;16;0;28;72
"354350 Riversul";8;0;0;0;0;6;14
"354425 Rosana";14;0;0;14;0;11;39
"354430 Roseira";5;3;0;4;0;21;33
"354440 Rubiácea";1;0;0;1;0;1;3
"354450 Rubinéia";1;0;0;0;0;6;7
"354460 Sabino";4;0;0;1;0;4;9
"354470 Sagres";1;0;0;0;0;0;1
"354480 Sales";7;0;0;4;0;8;19
"354490 Sales Oliveira";2;1;0;0;0;10;13
"354500 Salesópolis";13;1;0;3;0;11;28
"354515 Saltinho";10;1;0;0;0;7;18
"354520 Salto";109;7;0;28;0;137;281
"354530 Salto de Pirapora";21;0;0;3;0;61;85
"354540 Salto Grande";5;2;0;1;0;26;34
"354550 Sandovalina";2;0;0;3;0;5;10
"354560 Santa Adélia";9;1;0;3;0;18;31
"354570 Santa Albertina";3;0;0;2;0;13;18
"354580 Santa Bárbara d'Oeste";247;13;0;62;0;252;574
"354600 Santa Branca";12;0;0;8;0;20;40
"354610 Santa Clara d'Oeste";1;1;0;0;0;1;3
"354620 Santa Cruz da Conceição";3;0;0;0;0;2;5
"354625 Santa Cruz da Esperança";2;0;0;1;0;0;3
"354630 Santa Cruz das Palmeiras";14;1;0;6;0;15;36
"354640 Santa Cruz do Rio Pardo";33;0;2;8;0;52;95
"354650 Santa Ernestina";3;0;0;0;0;7;10
"354660 Santa Fé do Sul";34;1;0;9;0;77;121
"354670 Santa Gertrudes";17;2;0;5;0;15;39
"354680 Santa Isabel";24;3;0;14;0;75;116
"354690 Santa Lúcia";5;0;0;1;0;10;16
"354700 Santa Maria da Serra";2;0;0;1;0;5;8
"354710 Santa Mercedes";1;0;0;0;0;2;3
"354740 Santa Rita d'Oeste";1;0;0;0;0;1;2
"354750 Santa Rita do Passa Quatro";25;2;1;2;0;20;50
"354760 Santa Rosa de Viterbo";13;2;0;4;0;37;56
"354765 Santa Salete";2;0;0;0;0;0;2
"354720 Santana da Ponte Pensa";0;0;0;0;0;1;1
"354730 Santana de Parnaíba";69;5;0;46;0;128;248
"354770 Santo Anastácio";20;4;1;9;0;19;53
"354780 Santo André";888;140;12;292;5;3140;4477
"354790 Santo Antônio da Alegria";6;0;0;1;0;9;16
"354800 Santo Antônio de Posse";32;5;0;6;0;38;81
"354805 Santo Antônio do Aracanguá";1;0;0;2;0;5;8
"354810 Santo Antônio do Jardim";3;0;0;0;0;2;5
"354820 Santo Antônio do Pinhal";3;1;0;1;0;4;9
"354830 Santo Expedito";0;1;0;2;0;4;7
"354840 Santópolis do Aguapeí";1;0;0;0;0;4;5
"354850 Santos";982;181;6;313;5;5675;7162
"354860 São Bento do Sapucaí";7;1;0;2;0;11;21
"354870 São Bernardo do Campo";1251;181;25;395;2;1911;3765
"354880 São Caetano do Sul";200;13;4;42;1;786;1046
"354890 São Carlos";425;43;3;86;1;830;1388
"354900 São Francisco";0;0;1;0;0;5;6
"354910 São João da Boa Vista";138;20;1;23;0;136;318
"354920 São João das Duas Pontes";2;0;0;0;0;5;7
"354925 São João de Iracema";4;0;0;1;0;2;7
"354930 São João do Pau d'Alho";0;0;0;1;0;2;3
"354940 São Joaquim da Barra";37;5;0;8;1;100;151
"354950 São José da Bela Vista";0;2;0;1;0;16;19
"354960 São José do Barreiro";3;0;0;0;0;3;6
"354970 São José do Rio Pardo";25;0;0;2;0;60;87
"354980 São José do Rio Preto";1239;121;8;281;1;3491;5141
"354990 São José dos Campos";1367;92;16;150;3;2423;4051
"354995 São Lourenço da Serra";9;1;0;9;0;26;45
"355000 São Luís do Paraitinga";2;0;0;2;0;4;8
"355010 São Manuel";34;1;0;3;0;36;74
"355020 São Miguel Arcanjo";9;0;0;2;0;21;32
"355030 São Paulo";22415;4583;347;11149;81;61621;100196
"355040 São Pedro";43;10;0;8;0;70;131
"355050 São Pedro do Turvo";5;0;0;1;0;6;12
"355060 São Roque";80;10;1;20;0;195;306
"355070 São Sebastião";127;16;1;58;1;319;522
"355080 São Sebastião da Grama";5;0;0;1;0;7;13
"355090 São Simão";20;1;0;3;1;38;63
"355100 São Vicente";477;107;2;410;2;2253;3251
"355110 Sarapuí";0;0;0;2;0;11;13
"355120 Sarutaiá";2;0;0;1;0;0;3
"355130 Sebastianópolis do Sul";1;0;0;1;0;1;3
"355140 Serra Azul";37;5;0;12;0;65;119
"355160 Serra Negra";14;1;0;4;0;28;47
"355150 Serrana";37;7;0;14;0;99;157
"355170 Sertãozinho";118;17;0;36;0;376;547
"355180 Sete Barras";9;0;0;8;0;12;29
"355190 Severínia";11;3;0;6;0;12;32
"355200 Silveiras";6;1;0;1;0;7;15
"355210 Socorro";29;1;0;3;0;49;82
"355220 Sorocaba";1019;96;16;235;1;2695;4062
"355230 Sud Mennucci";2;2;0;3;0;2;9
"355240 Sumaré";233;25;2;74;0;602;936
"355255 Suzanápolis";4;1;0;2;0;1;8
"355250 Suzano";261;46;4;171;0;431;913
"355260 Tabapuã";19;0;0;3;0;17;39
"355270 Tabatinga";4;1;0;3;0;20;28
"355280 Taboão da Serra";292;97;2;242;0;624;1257
"355290 Taciba";4;0;0;2;0;3;9
"355300 Taguaí";9;1;0;1;0;9;20
"355310 Taiaçu";7;2;0;1;0;16;26
"355320 Taiúva";4;1;0;1;0;14;20
"355330 Tambaú";9;0;0;2;0;17;28
"355340 Tanabi";28;2;0;1;0;42;73
"355350 Tapiraí";3;1;0;4;0;15;23
"355360 Tapiratiba";1;1;0;0;0;8;10
"355365 Taquaral";7;2;0;2;0;12;23
"355370 Taquaritinga";102;14;0;16;0;366;498
"355380 Taquarituba";28;0;0;3;0;37;68
"355385 Taquarivaí";1;0;0;0;0;0;1
"355390 Tarabai";7;1;0;2;0;1;11
"355395 Tarumã";3;1;0;1;0;7;12
"355400 Tatuí";192;13;0;17;0;368;590
"355410 Taubaté";574;48;2;102;0;1543;2269
"355420 Tejupá";1;0;0;0;0;2;3
"355430 Teodoro Sampaio";19;0;0;10;0;22;51
"355440 Terra Roxa";13;2;0;4;0;8;27
"355450 Tietê";32;2;0;5;0;39;78
"355460 Timburi";2;0;0;0;0;0;2
"355465 Torre de Pedra";5;0;0;0;0;2;7
"355470 Torrinha";9;1;0;3;0;13;26
"355475 Trabiju";1;1;0;1;0;2;5
"355480 Tremembé";101;15;1;34;0;261;412
"355490 Três Fronteiras";4;0;0;1;0;11;16
"355495 Tuiuti";0;0;0;1;0;2;3
"355500 Tupã";115;13;1;46;0;127;302
"355510 Tupi Paulista";21;4;1;9;0;45;80
"355520 Turiúba";3;0;0;0;0;5;8
"355530 Turmalina";0;0;0;0;0;1;1
"355535 Ubarana";8;1;0;0;0;10;19
"355540 Ubatuba";88;9;1;34;0;289;421
"355550 Ubirajara";3;1;0;1;0;1;6
"355560 Uchoa";11;0;0;3;0;20;34
"355570 União Paulista";2;0;1;0;0;4;7
"355580 Urânia";3;0;0;0;0;10;13
"355590 Uru";2;0;0;0;0;5;7
"355600 Urupês";20;0;0;4;0;9;33
"355610 Valentim Gentil";11;1;0;2;0;6;20
"355620 Valinhos";140;4;2;25;0;143;314
"355630 Valparaíso";38;9;0;27;0;43;117
"355635 Vargem";4;0;0;2;0;3;9
"355640 Vargem Grande do Sul";34;5;0;5;0;69;113
"355645 Vargem Grande Paulista";35;5;1;13;0;77;131
"355650 Várzea Paulista";81;8;0;27;0;323;439
"355660 Vera Cruz";8;2;1;4;0;10;25
"355670 Vinhedo";87;4;0;11;0;114;216
"355680 Viradouro";16;1;0;4;0;20;41
"355690 Vista Alegre do Alto";8;3;0;1;0;4;16
"355695 Vitória Brasil";2;0;0;0;0;5;7
"355700 Votorantim";97;8;1;30;0;244;380
"355710 Votuporanga";273;23;2;86;0;289;673
"355715 Zacarias";1;0;0;0;0;2;3
"350000 Município ignorado - SP";15;1;0;6;0;151;173
"410010 Abatiá";3;0;0;0;0;2;5
"410020 Adrianópolis";3;0;0;0;0;1;4
"410030 Agudos do Sul";4;0;0;0;0;5;9
"410040 Almirante Tamandaré";215;7;0;34;1;199;456
"410045 Altamira do Paraná";1;0;0;0;0;0;1
"412862 Alto Paraíso";2;1;0;0;0;0;3
"410060 Alto Paraná";11;5;0;5;0;16;37
"410070 Alto Piquiri";9;0;0;4;0;7;20
"410050 Altônia";14;0;1;8;0;11;34
"410080 Alvorada do Sul";10;1;0;0;0;8;19
"410090 Amaporã";3;0;0;1;0;1;5
"410100 Ampére";5;0;0;0;0;6;11
"410110 Andirá";19;4;0;10;0;17;50
"410115 Ângulo";2;0;0;0;0;3;5
"410120 Antonina";35;2;0;6;0;39;82
"410130 Antônio Olinto";3;0;0;0;0;2;5
"410140 Apucarana";197;23;2;57;1;136;416
"410150 Arapongas";151;6;3;18;0;141;319
"410160 Arapoti";24;2;0;9;0;23;58
"410165 Arapuã";1;1;0;2;0;1;5
"410170 Araruna";8;0;0;3;0;3;14
"410180 Araucária";176;6;2;36;0;257;477
"410185 Ariranha do Ivaí";3;0;0;1;0;1;5
"410190 Assaí";25;5;0;5;0;18;53
"410200 Assis Chateaubriand";15;2;0;9;0;14;40
"410210 Astorga";31;1;0;3;0;22;57
"410220 Atalaia";6;0;0;1;0;2;9
"410230 Balsa Nova";4;0;0;0;0;3;7
"410240 Bandeirantes";21;3;0;3;0;24;51
"410250 Barbosa Ferraz";2;0;0;0;0;7;9
"410270 Barra do Jacaré";1;0;0;0;0;1;2
"410260 Barracão";6;0;0;2;0;11;19
"410280 Bela Vista do Paraíso";9;2;0;2;0;10;23
"410290 Bituruna";3;0;0;3;0;2;8
"410300 Boa Esperança";1;0;0;1;0;0;2
"410302 Boa Esperança do Iguaçu";1;0;0;0;0;2;3
"410304 Boa Ventura de São Roque";2;0;0;1;0;0;3
"410305 Boa Vista da Aparecida";14;1;0;6;0;2;23
"410310 Bocaiúva do Sul";15;0;0;2;0;6;23
"410315 Bom Jesus do Sul";2;0;0;0;0;5;7
"410320 Bom Sucesso";7;1;0;4;0;1;13
"410330 Borrazópolis";7;0;0;2;0;3;12
"410335 Braganey";4;0;0;0;0;2;6
"410337 Brasilândia do Sul";0;0;0;1;0;1;2
"410340 Cafeara";1;0;0;1;0;1;3
"410345 Cafelândia";15;2;0;6;0;6;29
"410347 Cafezal do Sul";2;0;0;1;0;2;5
"410350 Califórnia";7;0;0;0;0;1;8
"410360 Cambará";30;8;1;13;0;23;75
"410370 Cambé";129;17;0;38;1;140;325
"410380 Cambira";8;2;0;2;0;6;18
"410390 Campina da Lagoa";10;1;0;2;0;10;23
"410395 Campina do Simão";4;0;0;0;0;1;5
"410400 Campina Grande do Sul";87;6;1;12;0;56;162
"410405 Campo Bonito";3;0;0;0;0;0;3
"410410 Campo do Tenente";7;0;0;2;0;4;13
"410420 Campo Largo";119;10;1;18;1;176;325
"410425 Campo Magro";30;1;0;4;0;28;63
"410430 Campo Mourão";133;5;1;61;0;120;320
"410440 Cândido de Abreu";4;0;0;2;0;6;12
"410442 Candói";6;1;0;0;1;4;12
"410445 Cantagalo";7;0;0;5;0;16;28
"410450 Capanema";8;1;0;2;0;13;24
"410460 Capitão Leônidas Marques";20;0;0;8;0;14;42
"410465 Carambeí";9;0;0;3;0;7;19
"410470 Carlópolis";14;0;0;0;0;7;21
"410480 Cascavel";624;51;1;166;0;404;1246
"410490 Castro";95;6;1;19;0;116;237
"410500 Catanduvas";2;1;0;2;0;2;7
"410510 Centenário do Sul";5;0;0;0;0;8;13
"410520 Cerro Azul";11;0;0;1;0;3;15
"410530 Céu Azul";15;1;0;3;0;8;27
"410540 Chopinzinho";6;1;0;0;0;13;20
"410550 Cianorte";97;3;0;17;0;63;180
"410560 Cidade Gaúcha";10;2;0;9;0;11;32
"410570 Clevelândia";9;0;0;2;0;13;24
"410580 Colombo";464;30;5;57;1;516;1073
"410590 Colorado";12;0;0;5;0;10;27
"410600 Congonhinhas";11;1;0;2;0;6;20
"410610 Conselheiro Mairinck";2;0;0;0;0;2;4
"410620 Contenda";14;0;0;3;0;5;22
"410630 Corbélia";19;0;0;2;0;16;37
"410640 Cornélio Procópio";41;9;1;7;0;41;99
"410645 Coronel Domingos Soares";0;0;0;1;0;0;1
"410650 Coronel Vivida";6;1;0;0;0;13;20
"410655 Corumbataí do Sul";2;0;0;0;0;0;2
"410680 Cruz Machado";8;0;0;0;0;2;10
"410657 Cruzeiro do Iguaçu";0;0;0;0;0;2;2
"410660 Cruzeiro do Oeste";6;1;1;5;0;30;43
"410670 Cruzeiro do Sul";2;1;0;0;0;2;5
"410685 Cruzmaltina";0;0;0;0;0;1;1
"410690 Curitiba";4254;238;33;508;6;7992;13031
"410700 Curiúva";1;0;0;6;0;6;13
"410715 Diamante D'Oeste";3;0;1;0;0;0;4
"410710 Diamante do Norte";0;0;0;1;0;5;6
"410712 Diamante do Sul";1;0;0;2;0;1;4
"410720 Dois Vizinhos";12;0;0;2;0;27;41
"410725 Douradina";5;0;0;2;0;5;12
"410730 Doutor Camargo";3;0;0;2;0;0;5
"410740 Enéas Marques";2;0;0;0;0;2;4
"410750 Engenheiro Beltrão";7;3;0;12;0;12;34
"410753 Entre Rios do Oeste";1;0;0;1;0;0;2
"410752 Esperança Nova";1;0;0;0;0;0;1
"410754 Espigão Alto do Iguaçu";4;0;0;0;0;0;4
"410755 Farol";1;0;0;0;0;0;1
"410760 Faxinal";17;1;0;2;0;11;31
"410765 Fazenda Rio Grande";172;6;0;23;0;125;326
"410770 Fênix";2;0;0;3;0;2;7
"410773 Fernandes Pinheiro";2;0;0;0;0;2;4
"410775 Figueira";14;2;0;3;0;3;22
"410780 Floraí";4;1;0;0;0;3;8
"410790 Floresta";3;0;0;0;0;4;7
"410800 Florestópolis";4;0;0;1;0;4;9
"410810 Flórida";3;2;0;3;0;3;11
"410820 Formosa do Oeste";7;0;0;1;0;5;13
"410830 Foz do Iguaçu";775;78;10;144;0;691;1698
"410845 Foz do Jordão";4;0;1;2;0;1;8
"410832 Francisco Alves";4;0;0;2;0;1;7
"410840 Francisco Beltrão";65;1;0;18;0;108;192
"410850 General Carneiro";17;0;0;9;0;2;28
"410855 Godoy Moreira";0;0;0;0;0;1;1
"410860 Goioerê";10;3;0;7;0;20;40
"410865 Goioxim";4;0;0;0;0;2;6
"410870 Grandes Rios";3;0;0;1;0;4;8
"410880 Guaíra";33;3;0;21;3;50;110
"410890 Guairaçá";4;0;0;2;0;2;8
"410895 Guamiranga";4;0;0;0;0;5;9
"410900 Guapirama";6;0;0;0;0;5;11
"410920 Guaraci";1;0;0;1;0;3;5
"410930 Guaraniaçu";12;1;0;2;0;4;19
"410940 Guarapuava";460;22;4;96;5;191;778
"410950 Guaraqueçaba";10;0;0;1;0;3;14
"410960 Guaratuba";133;10;0;32;0;103;278
"410965 Honório Serpa";1;0;0;0;0;0;1
"410970 Ibaiti";77;9;0;12;0;19;117
"410975 Ibema";5;0;0;0;0;1;6
"410980 Ibiporã";64;6;0;15;0;44;129
"410990 Icaraíma";7;1;0;3;0;8;19
"411000 Iguaraçu";11;0;0;0;0;5;16
"411005 Iguatu";1;0;0;1;0;0;2
"411007 Imbaú";7;0;0;3;0;6;16
"411010 Imbituva";36;1;0;0;0;13;50
"411020 Inácio Martins";3;0;0;0;0;2;5
"411030 Inajá";0;0;0;2;0;1;3
"411040 Indianópolis";3;0;0;0;0;1;4
"411050 Ipiranga";7;0;0;1;0;2;10
"411060 Iporã";26;1;0;7;0;20;54
"411070 Irati";45;1;0;2;0;29;77
"411080 Iretama";2;0;0;2;0;2;6
"411090 Itaguajé";9;2;0;3;0;6;20
"411095 Itaipulândia";7;0;0;0;0;1;8
"411100 Itambaracá";3;0;0;3;0;2;8
"411110 Itambé";7;1;0;1;0;6;15
"411120 Itapejara d'Oeste";0;1;0;0;0;4;5
"411125 Itaperuçu";13;0;0;3;0;9;25
"411130 Itaúna do Sul";0;0;0;0;0;2;2
"411140 Ivaí";3;0;0;0;0;2;5
"411150 Ivaiporã";35;4;0;15;0;37;91
"411155 Ivaté";2;0;0;1;0;0;3
"411160 Ivatuba";4;1;0;0;0;1;6
"411170 Jaboti";5;0;0;1;0;1;7
"411180 Jacarezinho";104;39;1;27;0;101;272
"411190 Jaguapitã";12;3;0;5;0;34;54
"411200 Jaguariaíva";48;1;2;5;0;40;96
"411210 Jandaia do Sul";24;0;0;7;0;11;42
"411220 Janiópolis";3;0;0;3;0;3;9
"411230 Japira";6;0;0;3;0;1;10
"411240 Japurá";8;0;0;3;0;3;14
"411250 Jardim Alegre";7;0;0;1;0;9;17
"411260 Jardim Olinda";2;0;0;0;0;1;3
"411270 Jataizinho";8;1;0;3;0;9;21
"411275 Jesuítas";0;0;0;2;0;1;3
"411280 Joaquim Távora";9;0;0;2;0;10;21
"411290 Jundiaí do Sul";1;0;0;0;0;1;2
"411295 Juranda";3;0;0;2;0;7;12
"411300 Jussara";7;0;0;4;0;1;12
"411310 Kaloré";1;1;0;2;0;2;6
"411320 Lapa";40;1;0;3;0;39;83
"411325 Laranjal";3;0;1;3;0;4;11
"411330 Laranjeiras do Sul";60;0;0;11;0;28;99
"411340 Leópolis";1;0;0;0;0;3;4
"411342 Lidianópolis";2;1;0;1;0;2;6
"411350 Loanda";30;0;0;15;0;25;70
"411360 Lobato";3;0;0;0;0;1;4
"411370 Londrina";963;132;25;204;0;1270;2594
"411373 Luiziana";3;0;0;0;0;3;6
"411375 Lunardelli";3;1;0;0;0;3;7
"411380 Lupionópolis";4;0;0;4;0;9;17
"411390 Mallet";4;0;0;0;0;3;7
"411400 Mamborê";6;0;0;5;0;3;14
"411410 Mandaguaçu";28;1;0;5;0;19;53
"411420 Mandaguari";34;9;1;5;0;24;73
"411430 Mandirituba";24;1;0;2;0;28;55
"411435 Manfrinópolis";0;0;0;0;0;3;3
"411440 Mangueirinha";2;0;0;1;0;15;18
"411450 Manoel Ribas";5;2;0;0;1;10;18
"411460 Marechal Cândido Rondon";33;5;0;10;0;20;68
"411470 Maria Helena";4;0;0;1;0;1;6
"411480 Marialva";44;3;0;6;0;30;83
"411490 Marilândia do Sul";4;0;0;2;0;4;10
"411500 Marilena";4;0;0;1;0;2;7
"411510 Mariluz";3;1;0;2;0;8;14
"411520 Maringá";857;59;12;115;3;637;1683
"411530 Mariópolis";3;1;0;2;0;5;11
"411535 Maripá";3;0;0;1;0;1;5
"411540 Marmeleiro";4;0;0;2;0;13;19
"411545 Marquinho";0;0;0;1;0;0;1
"411550 Marumbi";0;0;0;1;0;2;3
"411560 Matelândia";13;3;0;4;0;10;30
"411570 Matinhos";93;6;0;19;0;92;210
"411575 Mauá da Serra";4;0;0;2;0;0;6
"411580 Medianeira";48;4;0;4;0;48;104
"411585 Mercedes";2;0;0;0;0;3;5
"411590 Mirador";0;0;0;0;0;1;1
"411600 Miraselva";0;0;1;0;0;0;1
"411605 Missal";4;0;0;0;0;4;8
"411610 Moreira Sales";3;1;0;5;0;2;11
"411620 Morretes";26;1;0;5;0;28;60
"411630 Munhoz de Melo";5;1;0;0;0;3;9
"411640 Nossa Senhora das Graças";3;0;0;1;0;1;5
"411650 Nova Aliança do Ivaí";1;1;0;0;0;0;2
"411660 Nova América da Colina";1;0;0;0;0;2;3
"411670 Nova Aurora";8;2;1;3;0;4;18
"411680 Nova Cantu";1;0;0;3;0;1;5
"411690 Nova Esperança";28;0;0;5;0;32;65
"411695 Nova Esperança do Sudoeste";2;0;0;0;0;0;2
"411700 Nova Fátima";21;1;0;3;0;9;34
"411705 Nova Laranjeiras";4;0;0;1;1;5;11
"411710 Nova Londrina";16;3;0;4;0;13;36
"411720 Nova Olímpia";3;0;0;6;0;10;19
"411725 Nova Prata do Iguaçu";4;0;0;3;0;9;16
"411721 Nova Santa Bárbara";2;1;0;0;0;1;4
"411722 Nova Santa Rosa";3;0;0;1;0;3;7
"411727 Nova Tebas";2;0;0;2;0;3;7
"411730 Ortigueira";8;0;0;1;0;9;18
"411740 Ourizona";4;0;0;0;0;0;4
"411745 Ouro Verde do Oeste";0;0;0;0;0;1;1
"411750 Paiçandu";39;2;0;12;0;28;81
"411760 Palmas";34;6;0;13;1;28;82
"411770 Palmeira";16;0;0;3;0;17;36
"411780 Palmital";7;0;0;3;0;5;15
"411790 Palotina";27;3;0;16;0;17;63
"411800 Paraíso do Norte";5;1;0;1;0;6;13
"411810 Paranacity";6;0;0;3;0;8;17
"411820 Paranaguá";716;41;3;162;1;653;1576
"411830 Paranapoema";1;1;0;0;0;1;3
"411840 Paranavaí";94;13;2;23;0;118;250
"411845 Pato Bragado";4;0;0;1;0;3;8
"411850 Pato Branco";97;8;1;45;0;111;262
"411860 Paula Freitas";3;0;0;1;0;1;5
"411870 Paulo Frontin";2;0;0;1;0;3;6
"411880 Peabiru";8;1;0;9;0;5;23
"411885 Perobal";2;0;0;2;0;1;5
"411890 Pérola";3;0;0;2;0;7;12
"411900 Pérola d'Oeste";2;0;0;0;0;6;8
"411910 Piên";8;0;0;0;0;7;15
"411915 Pinhais";313;30;1;76;0;586;1006
"411920 Pinhalão";3;1;0;1;0;3;8
"411930 Pinhão";13;0;0;5;0;10;28
"411940 Piraí do Sul";19;1;0;2;0;23;45
"411950 Piraquara";186;17;1;54;0;184;442
"411960 Pitanga";26;0;0;1;0;12;39
"411965 Pitangueiras";0;1;0;2;0;1;4
"411970 Planaltina do Paraná";0;1;0;2;0;0;3
"411980 Planalto";5;0;0;0;0;3;8
"411990 Ponta Grossa";752;10;3;117;2;642;1526
"411995 Pontal do Paraná";67;1;0;17;0;49;134
"412000 Porecatu";17;5;0;6;0;16;44
"412010 Porto Amazonas";3;0;0;0;0;0;3
"412015 Porto Barreiro";1;0;0;2;0;0;3
"412020 Porto Rico";5;1;0;0;0;5;11
"412030 Porto Vitória";2;0;0;0;0;1;3
"412033 Prado Ferreira";1;0;0;0;0;1;2
"412035 Pranchita";4;1;0;1;0;7;13
"412040 Presidente Castelo Branco";2;1;0;1;0;7;11
"412050 Primeiro de Maio";4;1;0;3;0;6;14
"412060 Prudentópolis";31;0;0;0;0;17;48
"412070 Quatiguá";13;1;0;1;0;3;18
"412080 Quatro Barras";44;1;0;1;0;19;65
"412085 Quatro Pontes";9;0;0;0;0;4;13
"412090 Quedas do Iguaçu";21;2;0;7;1;8;39
"412100 Querência do Norte";6;1;0;0;0;4;11
"412110 Quinta do Sol";3;1;0;7;0;8;19
"412120 Quitandinha";6;0;0;1;0;6;13
"412125 Ramilândia";4;0;0;3;0;1;8
"412130 Rancho Alegre";1;2;0;0;0;2;5
"412135 Rancho Alegre D'Oeste";1;0;0;0;0;1;2
"412140 Realeza";12;0;0;0;0;14;26
"412150 Rebouças";17;0;0;1;0;10;28
"412160 Renascença";1;0;0;2;0;4;7
"412170 Reserva";14;0;0;1;0;9;24
"412175 Reserva do Iguaçu";1;0;0;0;0;1;2
"412180 Ribeirão Claro";7;1;0;1;0;10;19
"412190 Ribeirão do Pinhal";5;0;0;1;0;10;16
"412200 Rio Azul";1;0;0;0;0;2;3
"412215 Rio Bonito do Iguaçu";7;2;0;2;0;6;17
"412217 Rio Branco do Ivaí";0;0;0;1;0;0;1
"412220 Rio Branco do Sul";33;1;1;2;0;36;73
"412230 Rio Negro";31;0;0;1;0;32;64
"412240 Rolândia";74;10;0;20;0;77;181
"412250 Roncador";6;0;0;5;0;5;16
"412260 Rondon";3;0;0;2;0;2;7
"412265 Rosário do Ivaí";0;1;0;2;0;3;6
"412270 Sabáudia";1;0;0;0;0;4;5
"412280 Salgado Filho";1;0;0;0;0;0;1
"412290 Salto do Itararé";1;0;0;1;0;2;4
"412300 Salto do Lontra";4;0;0;1;0;11;16
"412310 Santa Amélia";0;2;0;0;0;5;7
"412320 Santa Cecília do Pavão";3;0;0;4;0;2;9
"412330 Santa Cruz de Monte Castelo";2;1;0;0;0;3;6
"412340 Santa Fé";15;1;0;0;0;23;39
"412350 Santa Helena";15;1;0;6;0;13;35
"412360 Santa Inês";0;0;0;1;0;1;2
"412370 Santa Isabel do Ivaí";0;0;0;1;0;2;3
"412380 Santa Izabel do Oeste";4;0;0;4;0;6;14
"412382 Santa Lúcia";5;0;0;5;0;3;13
"412385 Santa Maria do Oeste";5;0;0;0;0;2;7
"412390 Santa Mariana";6;0;0;1;0;7;14
"412395 Santa Mônica";2;0;0;0;0;0;2
"412402 Santa Tereza do Oeste";11;0;0;4;0;1;16
"412405 Santa Terezinha de Itaipu";33;2;1;5;0;32;73
"412400 Santana do Itararé";1;0;0;0;0;5;6
"412410 Santo Antônio da Platina";63;8;0;8;0;34;113
"412420 Santo Antônio do Caiuá";0;1;0;1;0;10;12
"412430 Santo Antônio do Paraíso";2;0;0;0;0;1;3
"412440 Santo Antônio do Sudoeste";5;0;0;2;0;12;19
"412450 Santo Inácio";5;0;0;0;0;4;9
"412460 São Carlos do Ivaí";4;0;0;1;0;3;8
"412470 São Jerônimo da Serra";9;0;0;2;1;6;18
"412480 São João";1;0;0;0;0;4;5
"412490 São João do Caiuá";4;0;0;3;0;6;13
"412500 São João do Ivaí";6;0;0;3;0;6;15
"412510 São João do Triunfo";2;0;0;0;0;2;4
"412520 São Jorge d'Oeste";5;0;0;1;0;8;14
"412530 São Jorge do Ivaí";2;0;0;0;0;1;3
"412535 São Jorge do Patrocínio";7;1;0;0;0;5;13
"412540 São José da Boa Vista";4;0;0;0;0;1;5
"412545 São José das Palmeiras";2;0;0;3;0;0;5
"412550 São José dos Pinhais";388;29;2;128;1;627;1175
"412555 São Manoel do Paraná";1;0;0;1;0;3;5
"412560 São Mateus do Sul";30;0;0;12;0;21;63
"412570 São Miguel do Iguaçu";30;2;0;6;0;19;57
"412575 São Pedro do Iguaçu";4;0;0;2;0;3;9
"412580 São Pedro do Ivaí";5;0;0;2;0;7;14
"412600 São Sebastião da Amoreira";5;0;0;1;0;4;10
"412610 São Tomé";4;0;0;2;0;3;9
"412620 Sapopema";6;0;0;3;0;3;12
"412625 Sarandi";165;17;2;40;0;129;353
"412627 Saudade do Iguaçu";2;0;0;2;0;4;8
"412630 Sengés";6;1;0;4;0;6;17
"412635 Serranópolis do Iguaçu";3;0;0;1;0;3;7
"412640 Sertaneja";6;0;0;3;0;4;13
"412650 Sertanópolis";13;5;0;3;0;7;28
"412660 Siqueira Campos";21;1;0;2;1;9;34
"412665 Sulina";2;0;0;0;0;2;4
"412667 Tamarana";5;0;0;1;2;2;10
"412670 Tamboara";4;0;0;1;0;3;8
"412680 Tapejara";13;1;0;5;0;10;29
"412690 Tapira";2;0;0;1;0;0;3
"412700 Teixeira Soares";4;1;0;2;0;3;10
"412710 Telêmaco Borba";77;11;0;12;0;68;168
"412720 Terra Boa";6;0;0;1;0;2;9
"412730 Terra Rica";8;0;0;2;0;6;16
"412740 Terra Roxa";5;0;0;4;0;7;16
"412750 Tibagi";14;2;0;3;0;13;32
"412760 Tijucas do Sul";9;0;0;1;0;7;17
"412770 Toledo";138;14;1;53;0;96;302
"412780 Tomazina";4;1;0;0;0;0;5
"412785 Três Barras do Paraná";26;0;0;2;0;8;36
"412788 Tunas do Paraná";2;0;0;0;0;2;4
"412790 Tuneiras do Oeste";5;0;0;1;0;0;6
"412795 Tupãssi";10;0;0;0;0;4;14
"412796 Turvo";10;0;1;0;0;3;14
"412800 Ubiratã";16;1;0;8;0;21;46
"412810 Umuarama";122;10;2;59;0;102;295
"412820 União da Vitória";94;7;0;18;0;72;191
"412830 Uniflor";1;0;0;0;0;2;3
"412840 Uraí";2;1;2;2;0;7;14
"412853 Ventania";10;0;0;0;0;0;10
"412855 Vera Cruz do Oeste";6;0;0;0;0;4;10
"412860 Verê";0;0;0;0;0;7;7
"412865 Virmond";0;0;0;1;0;1;2
"412870 Vitorino";1;0;0;0;0;5;6
"412850 Wenceslau Braz";22;1;0;4;0;17;44
"412880 Xambrê";7;1;0;2;0;10;20
"410000 Município ignorado - PR";2;0;0;0;0;6;8
"420010 Abelardo Luz";27;4;0;1;0;10;42
"420020 Agrolândia";9;0;0;0;0;6;15
"420030 Agronômica";8;0;0;0;0;3;11
"420040 Água Doce";4;0;0;2;0;3;9
"420050 Águas de Chapecó";8;1;0;0;0;2;11
"420055 Águas Frias";1;0;0;0;0;0;1
"420060 Águas Mornas";7;2;0;0;0;9;18
"420070 Alfredo Wagner";8;0;0;0;0;4;12
"420075 Alto Bela Vista";0;0;0;0;0;1;1
"420080 Anchieta";3;0;0;0;0;2;5
"420090 Angelina";5;0;0;0;0;3;8
"420100 Anita Garibaldi";3;0;0;2;0;2;7
"420110 Anitápolis";6;0;0;0;0;2;8
"420120 Antônio Carlos";9;0;0;1;0;5;15
"420125 Apiúna";25;0;0;0;0;13;38
"420127 Arabutã";3;1;0;0;0;1;5
"420130 Araquari";78;10;0;7;0;29;124
"420140 Araranguá";309;7;0;5;0;107;428
"420150 Armazém";7;0;0;0;0;6;13
"420160 Arroio Trinta";2;0;0;0;0;2;4
"420165 Arvoredo";0;0;0;0;0;1;1
"420170 Ascurra";30;1;0;2;0;10;43
"420180 Atalanta";6;0;0;0;0;1;7
"420190 Aurora";6;0;0;0;0;4;10
"420195 Balneário Arroio do Silva";72;6;0;0;0;33;111
"420205 Balneário Barra do Sul";30;1;0;3;0;24;58
"420200 Balneário Camboriú";938;34;2;44;0;635;1653
"420207 Balneário Gaivota";34;2;0;1;0;7;44
"420208 Bandeirante";1;0;0;1;0;0;2
"420210 Barra Velha";75;3;0;9;0;71;158
"420213 Bela Vista do Toldo";0;0;0;0;0;1;1
"420220 Benedito Novo";9;1;0;0;0;6;16
"420230 Biguaçu";349;29;2;14;2;256;652
"420240 Blumenau";1317;78;3;112;1;950;2461
"420243 Bocaina do Sul";3;0;0;0;0;2;5
"420250 Bom Jardim da Serra";3;0;0;0;0;1;4
"420253 Bom Jesus";3;0;0;1;0;2;6
"420257 Bom Jesus do Oeste";1;0;0;0;0;0;1
"420260 Bom Retiro";3;0;0;4;0;9;16
"420245 Bombinhas";39;1;0;0;1;26;67
"420270 Botuverá";5;1;0;0;0;5;11
"420280 Braço do Norte";67;6;1;3;0;29;106
"420285 Braço do Trombudo";8;0;0;0;0;2;10
"420287 Brunópolis";2;0;0;0;0;1;3
"420290 Brusque";454;7;0;6;1;371;839
"420300 Caçador";98;5;2;18;0;79;202
"420310 Caibi";7;0;0;0;0;6;13
"420315 Calmon";2;0;0;0;0;0;2
"420320 Camboriú";465;15;1;21;0;371;873
"420330 Campo Alegre";14;0;0;1;0;3;18
"420340 Campo Belo do Sul";13;0;0;0;0;3;16
"420350 Campo Erê";12;0;0;0;0;8;20
"420360 Campos Novos";64;3;1;11;0;29;108
"420370 Canelinha";22;2;0;1;0;19;44
"420380 Canoinhas";49;1;0;2;0;34;86
"420325 Capão Alto";1;1;0;0;0;3;5
"420390 Capinzal";21;2;0;0;0;2;25
"420395 Capivari de Baixo";59;4;0;2;0;76;141
"420400 Catanduvas";6;0;0;3;0;4;13
"420410 Caxambu do Sul";7;1;0;0;0;1;9
"420415 Celso Ramos";0;0;0;0;0;3;3
"420417 Cerro Negro";1;0;0;0;0;0;1
"420420 Chapecó";578;22;0;68;2;244;914
"420425 Cocal do Sul";50;1;0;0;0;19;70
"420430 Concórdia";109;1;0;6;0;51;167
"420435 Cordilheira Alta";9;0;0;0;0;1;10
"420440 Coronel Freitas";3;0;0;0;0;1;4
"420445 Coronel Martins";1;0;0;0;0;0;1
"420455 Correia Pinto";11;1;0;7;0;21;40
"420450 Corupá";22;0;0;2;0;14;38
"420460 Criciúma";1151;132;0;52;0;884;2219
"420470 Cunha Porã";6;0;0;0;0;7;13
"420475 Cunhataí";1;0;0;0;0;1;2
"420480 Curitibanos";56;7;0;19;0;63;145
"420490 Descanso";7;1;0;0;0;1;9
"420500 Dionísio Cerqueira";26;0;0;1;0;5;32
"420510 Dona Emma";4;0;0;0;0;1;5
"420515 Doutor Pedrinho";1;0;0;0;0;1;2
"420517 Entre Rios";2;0;0;1;1;1;5
"420519 Ermo";1;0;0;1;0;1;3
"420520 Erval Velho";2;0;0;0;0;2;4
"420530 Faxinal dos Guedes";9;0;0;2;0;6;17
"420535 Flor do Sertão";3;0;0;0;0;1;4
"420540 Florianópolis";2763;401;6;225;9;3308;6712
"420543 Formosa do Sul";1;0;0;0;0;2;3
"420545 Forquilhinha";62;0;0;2;0;24;88
"420550 Fraiburgo";51;0;0;6;0;20;77
"420560 Galvão";8;0;0;0;0;1;9
"420570 Garopaba";52;2;0;2;0;39;95
"420580 Garuva";37;0;0;2;0;13;52
"420590 Gaspar";169;12;0;14;0;112;307
"420600 Governador Celso Ramos";31;2;0;3;0;31;67
"420610 Grão Pará";13;0;0;0;0;4;17
"420620 Gravatal";25;1;1;0;0;8;35
"420630 Guabiruba";35;3;0;2;0;24;64
"420640 Guaraciaba";3;0;0;0;0;4;7
"420650 Guaramirim";99;2;0;4;0;31;136
"420660 Guarujá do Sul";1;0;0;0;0;2;3
"420665 Guatambú";3;0;0;1;0;0;4
"420670 Herval d'Oeste";40;10;1;21;0;23;95
"420680 Ibicaré";3;0;0;0;0;6;9
"420690 Ibirama";52;2;0;1;0;17;72
"420700 Içara";271;9;1;7;0;102;390
"420710 Ilhota";18;0;0;1;0;18;37
"420720 Imaruí";23;0;0;1;0;20;44
"420730 Imbituba";230;16;0;4;0;155;405
"420740 Imbuia";6;0;0;0;0;3;9
"420750 Indaial";191;8;0;4;0;93;296
"420757 Iomerê";1;0;0;0;0;3;4
"420760 Ipira";2;0;0;0;0;0;2
"420765 Iporã do Oeste";6;0;0;2;0;2;10
"420768 Ipuaçu";4;1;0;3;6;2;16
"420770 Ipumirim";5;1;0;0;0;11;17
"420775 Iraceminha";4;0;0;0;0;0;4
"420780 Irani";7;0;0;2;0;2;11
"420790 Irineópolis";2;0;0;0;0;2;4
"420800 Itá";2;0;0;0;0;1;3
"420810 Itaiópolis";8;0;0;0;0;6;14
"420820 Itajaí";1565;161;13;120;5;2034;3898
"420830 Itapema";199;17;1;12;0;117;346
"420840 Itapiranga";5;0;0;0;0;1;6
"420845 Itapoá";23;3;1;3;0;12;42
"420850 Ituporanga";41;3;0;1;0;26;71
"420870 Jacinto Machado";17;0;0;0;0;3;20
"420880 Jaguaruna";45;3;0;3;0;20;71
"420890 Jaraguá do Sul";494;22;3;30;1;104;654
"420895 Jardinópolis";2;0;0;0;0;0;2
"420900 Joaçaba";47;10;0;7;0;45;109
"420910 Joinville";2601;148;1;147;3;1400;4300
"420915 José Boiteux";3;0;0;0;8;3;14
"420920 Lacerdópolis";2;0;0;0;0;0;2
"420930 Lages";393;47;7;96;1;454;998
"420940 Laguna";243;32;0;9;1;219;504
"420950 Laurentino";12;0;0;1;0;6;19
"420960 Lauro Muller";33;1;0;2;0;20;56
"420970 Lebon Régis";7;0;0;3;0;6;16
"420980 Leoberto Leal";2;0;0;0;0;0;2
"420985 Lindóia do Sul";3;1;0;0;0;1;5
"420990 Lontras";33;1;0;0;0;10;44
"421000 Luiz Alves";4;1;0;0;0;7;12
"421003 Luzerna";6;0;0;1;0;4;11
"421005 Macieira";1;0;0;0;0;1;2
"421010 Mafra";47;0;1;5;1;47;101
"421020 Major Gercino";3;0;0;1;0;4;8
"421030 Major Vieira";0;0;0;0;0;4;4
"421040 Maracajá";16;0;0;0;0;2;18
"421050 Maravilha";30;0;1;1;0;15;47
"421055 Marema";4;1;0;0;0;3;8
"421060 Massaranduba";26;1;0;1;0;11;39
"421070 Matos Costa";1;0;0;0;0;1;2
"421080 Meleiro";8;0;0;0;0;3;11
"421085 Mirim Doce";4;0;0;0;0;0;4
"421090 Modelo";7;0;0;0;0;1;8
"421100 Mondaí";11;0;0;0;1;2;14
"421105 Monte Carlo";15;0;0;2;0;4;21
"421110 Monte Castelo";2;0;0;0;0;5;7
"421120 Morro da Fumaça";43;6;0;2;0;26;77
"421125 Morro Grande";2;0;0;0;0;1;3
"421130 Navegantes";261;23;1;45;0;259;589
"421140 Nova Erechim";1;0;0;0;0;0;1
"421145 Nova Itaberaba";2;0;0;1;0;0;3
"421150 Nova Trento";20;0;0;2;0;26;48
"421160 Nova Veneza";31;0;0;2;0;12;45
"421165 Novo Horizonte";1;0;0;0;0;0;1
"421170 Orleans";59;1;0;3;0;20;83
"421175 Otacílio Costa";33;1;1;2;0;13;50
"421180 Ouro";4;0;0;0;0;1;5
"421185 Ouro Verde";1;0;0;0;0;1;2
"421189 Painel";2;0;0;0;0;1;3
"421190 Palhoça";473;41;0;25;1;607;1147
"421200 Palma Sola";7;0;0;0;0;5;12
"421205 Palmeira";2;0;1;1;0;1;5
"421210 Palmitos";19;1;0;0;0;4;24
"421220 Papanduva";5;0;0;0;0;5;10
"421223 Paraíso";2;0;0;0;0;0;2
"421225 Passo de Torres";18;2;0;1;0;3;24
"421227 Passos Maia";0;0;0;0;0;1;1
"421230 Paulo Lopes";12;0;0;1;0;16;29
"421240 Pedras Grandes";2;0;0;0;0;2;4
"421250 Penha";85;4;0;1;0;68;158
"421260 Peritiba";0;0;0;0;0;1;1
"421270 Petrolândia";7;0;0;0;0;1;8
"421280 Piçarras";73;2;0;5;0;70;150
"421290 Pinhalzinho";24;0;0;2;0;7;33
"421300 Pinheiro Preto";1;0;0;0;0;1;2
"421310 Piratuba";3;0;0;0;0;3;6
"421315 Planalto Alegre";1;0;0;0;0;2;3
"421320 Pomerode";67;2;0;2;0;16;87
"421330 Ponte Alta";3;2;0;4;0;7;16
"421335 Ponte Alta do Norte";4;0;0;0;0;3;7
"421340 Ponte Serrada";26;4;0;3;0;10;43
"421350 Porto Belo";45;8;0;2;0;42;97
"421360 Porto União";50;0;0;5;0;22;77
"421370 Pouso Redondo";34;2;0;2;0;10;48
"421380 Praia Grande";12;0;0;0;0;3;15
"421390 Presidente Castelo Branco";1;0;0;0;0;1;2
"421400 Presidente Getúlio";21;0;0;0;1;6;28
"421410 Presidente Nereu";5;0;0;1;0;2;8
"421415 Princesa";2;0;0;0;0;1;3
"421420 Quilombo";10;0;0;1;0;5;16
"421430 Rancho Queimado";2;0;0;0;0;2;4
"421440 Rio das Antas";2;0;0;0;0;3;5
"421450 Rio do Campo";4;0;0;0;0;0;4
"421460 Rio do Oeste";10;0;0;0;0;1;11
"421480 Rio do Sul";356;12;1;3;0;150;522
"421470 Rio dos Cedros";23;0;0;0;0;8;31
"421490 Rio Fortuna";5;0;0;0;0;2;7
"421500 Rio Negrinho";50;1;0;3;0;16;70
"421505 Rio Rufino";0;0;0;0;0;1;1
"421507 Riqueza";1;0;0;0;0;0;1
"421510 Rodeio";24;1;0;2;0;1;28
"421520 Romelândia";1;0;0;0;0;2;3
"421530 Salete";14;0;0;0;0;5;19
"421535 Saltinho";1;0;0;0;0;0;1
"421540 Salto Veloso";1;0;0;0;0;0;1
"421545 Sangão";19;1;0;0;1;14;35
"421550 Santa Cecília";20;0;0;0;0;8;28
"421560 Santa Rosa de Lima";2;0;0;0;0;1;3
"421565 Santa Rosa do Sul";17;0;0;1;0;5;23
"421570 Santo Amaro da Imperatriz";36;4;0;0;0;43;83
"421580 São Bento do Sul";130;2;1;16;0;81;230
"421575 São Bernardino";0;0;0;0;0;2;2
"421590 São Bonifácio";2;1;0;0;0;0;3
"421600 São Carlos";13;0;0;0;0;2;15
"421605 São Cristovão do Sul";9;2;0;3;0;13;27
"421610 São Domingos";6;0;0;1;0;4;11
"421620 São Francisco do Sul";249;22;1;19;6;150;447
"421630 São João Batista";83;0;0;2;0;61;146
"421635 São João do Itaperiú";7;0;0;1;0;4;12
"421625 São João do Oeste";3;0;0;0;0;0;3
"421640 São João do Sul";8;0;0;0;0;7;15
"421650 São Joaquim";30;3;0;7;0;31;71
"421660 São José";1380;172;5;85;2;1121;2765
"421670 São José do Cedro";16;0;0;1;0;8;25
"421680 São José do Cerrito";4;0;0;5;0;5;14
"421690 São Lourenço do Oeste";18;0;0;0;0;20;38
"421700 São Ludgero";17;1;0;1;0;7;26
"421710 São Martinho";2;0;0;0;0;1;3
"421715 São Miguel da Boa Vista";2;0;0;0;0;0;2
"421720 São Miguel do Oeste";67;0;0;2;0;43;112
"421725 São Pedro de Alcântara";24;3;0;0;0;37;64
"421730 Saudades";3;0;0;0;0;2;5
"421740 Schroeder";35;1;0;3;0;8;47
"421750 Seara";15;1;0;0;0;7;23
"421755 Serra Alta";2;0;0;0;0;1;3
"421760 Siderópolis";31;1;0;2;0;23;57
"421770 Sombrio";70;6;0;5;0;45;126
"421775 Sul Brasil";1;0;0;0;0;1;2
"421780 Taió";35;0;1;0;0;19;55
"421790 Tangará";7;0;0;2;0;6;15
"421800 Tijucas";176;12;0;9;0;133;330
"421810 Timbé do Sul";7;0;0;0;0;4;11
"421820 Timbó";90;2;0;5;0;27;124
"421825 Timbó Grande";5;0;0;0;0;2;7
"421830 Três Barras";31;0;0;2;0;12;45
"421835 Treviso";3;0;0;0;0;0;3
"421840 Treze de Maio";15;0;0;1;0;7;23
"421850 Treze Tílias";2;1;0;1;0;3;7
"421860 Trombudo Central";12;0;0;0;0;3;15
"421870 Tubarão";447;40;4;25;1;246;763
"421875 Tunápolis";1;0;0;0;0;0;1
"421880 Turvo";15;0;0;0;0;5;20
"421885 União do Oeste";1;0;0;1;0;0;2
"421890 Urubici";6;1;0;3;0;8;18
"421895 Urupema";3;0;0;0;0;3;6
"421900 Urussanga";41;1;0;1;0;50;93
"421910 Vargeão";4;1;0;1;0;3;9
"421915 Vargem";2;0;0;0;0;0;2
"421917 Vargem Bonita";2;0;0;0;0;1;3
"421920 Vidal Ramos";5;1;0;0;0;2;8
"421930 Videira";94;5;1;4;0;64;168
"421935 Vitor Meireles";4;0;0;0;3;1;8
"421940 Witmarsum";4;0;0;1;0;8;13
"421950 Xanxerê";80;7;0;19;0;49;155
"421960 Xavantina";1;0;0;0;0;0;1
"421970 Xaxim";26;4;0;2;0;13;45
"421985 Zortéa";1;0;0;0;0;1;2
"420000 Município ignorado - SC";1;0;0;0;0;1;2
"430005 Água Santa";3;0;0;0;0;1;4
"430010 Agudo";12;1;0;0;0;8;21
"430020 Ajuricaba";6;0;0;0;0;6;12
"430030 Alecrim";2;0;0;1;0;6;9
"430040 Alegrete";256;26;0;48;0;176;506
"430045 Alegria";1;0;0;0;0;2;3
"430047 Almirante Tamandaré do Sul";1;0;0;0;0;1;2
"430050 Alpestre";2;0;0;0;0;6;8
"430055 Alto Alegre";3;0;0;0;0;0;3
"430057 Alto Feliz";2;0;0;0;0;2;4
"430060 Alvorada";1238;343;1;161;6;1113;2862
"430063 Amaral Ferrador";3;0;0;0;0;2;5
"430064 Ametista do Sul";4;0;0;0;0;5;9
"430066 André da Rocha";1;1;0;0;0;0;2
"430070 Anta Gorda";8;0;0;0;0;3;11
"430080 Antônio Prado";10;0;0;1;0;3;14
"430085 Arambaré";3;0;0;1;0;4;8
"430087 Araricá";8;0;0;1;0;4;13
"430090 Aratiba";2;1;0;0;0;2;5
"430100 Arroio do Meio";26;4;0;0;0;13;43
"430107 Arroio do Padre";1;0;0;0;0;1;2
"430105 Arroio do Sal";20;0;0;0;1;7;28
"430120 Arroio do Tigre";8;0;0;2;0;3;13
"430110 Arroio dos Ratos";42;8;0;6;0;62;118
"430130 Arroio Grande";29;1;0;3;0;26;59
"430140 Arvorezinha";3;0;0;1;0;4;8
"430150 Augusto Pestana";1;0;0;0;0;7;8
"430155 Áurea";2;0;0;0;0;3;5
"430160 Bagé";118;37;0;21;1;192;369
"430163 Balneário Pinhal";27;2;1;4;1;22;57
"430165 Barão";6;0;0;0;0;0;6
"430170 Barão de Cotegipe";4;0;0;0;0;1;5
"430175 Barão do Triunfo";4;0;0;1;0;6;11
"430185 Barra do Guarita";2;0;0;0;0;2;4
"430187 Barra do Quaraí";4;0;0;1;0;10;15
"430190 Barra do Ribeiro";26;5;0;6;0;17;54
"430192 Barra do Rio Azul";1;0;0;0;0;0;1
"430195 Barra Funda";1;0;0;1;0;0;2
"430180 Barracão";0;0;0;0;0;4;4
"430200 Barros Cassal";3;0;0;1;0;3;7
"430205 Benjamin Constant do Sul";0;0;0;0;0;2;2
"430210 Bento Gonçalves";279;30;1;64;0;95;469
"430215 Boa Vista das Missões";1;0;0;0;0;1;2
"430220 Boa Vista do Buricá";5;0;0;0;0;2;7
"430223 Boa Vista do Incra";2;0;0;0;0;0;2
"430230 Bom Jesus";18;1;1;10;0;16;46
"430235 Bom Princípio";15;1;0;0;0;5;21
"430237 Bom Progresso";0;0;0;0;0;1;1
"430240 Bom Retiro do Sul";30;1;0;3;0;15;49
"430245 Boqueirão do Leão";8;0;0;0;0;7;15
"430250 Bossoroca";3;0;1;0;0;5;9
"430260 Braga";1;0;0;0;0;1;2
"430265 Brochier";1;0;0;0;0;1;2
"430270 Butiá";53;6;1;5;0;62;127
"430280 Caçapava do Sul";40;6;0;21;0;72;139
"430290 Cacequi";29;4;1;8;0;20;62
"430300 Cachoeira do Sul";314;65;1;71;0;234;685
"430310 Cachoeirinha";317;43;2;23;1;528;914
"430320 Cacique Doble";1;0;0;0;5;1;7
"430330 Caibaté";0;0;0;0;0;7;7
"430340 Caiçara";1;0;0;0;0;2;3
"430350 Camaquã";161;25;0;21;1;130;338
"430355 Camargo";1;0;0;0;0;0;1
"430360 Cambará do Sul";2;0;0;1;0;6;9
"430367 Campestre da Serra";1;0;0;1;0;1;3
"430370 Campina das Missões";2;1;0;0;0;2;5
"430380 Campinas do Sul";1;0;0;1;0;6;8
"430390 Campo Bom";181;7;1;29;0;125;343
"430400 Campo Novo";0;0;0;1;0;7;8
"430410 Campos Borges";2;0;0;0;0;1;3
"430420 Candelária";29;6;0;7;0;14;56
"430430 Cândido Godói";1;0;0;0;0;0;1
"430435 Candiota";7;1;0;0;0;4;12
"430440 Canela";103;9;0;19;0;76;207
"430450 Canguçu";18;2;0;0;0;33;53
"430460 Canoas";1330;182;3;151;6;2084;3756
"430461 Canudos do Vale";3;0;0;0;0;0;3
"430462 Capão Bonito do Sul";4;0;0;0;0;0;4
"430463 Capão da Canoa";154;12;0;7;0;206;379
"430465 Capão do Cipó";5;0;0;1;0;1;7
"430466 Capão do Leão";22;5;0;1;0;51;79
"430468 Capela de Santana";7;1;0;2;0;5;15
"430469 Capitão";1;0;0;1;0;0;2
"430467 Capivari do Sul";10;0;0;0;0;3;13
"430471 Caraá";3;0;0;0;0;4;7
"430470 Carazinho";110;3;0;11;0;133;257
"430480 Carlos Barbosa";46;1;0;4;0;19;70
"430490 Casca";13;0;0;1;0;3;17
"430495 Caseiros";2;0;0;0;0;1;3
"430500 Catuípe";12;0;0;2;0;21;35
"430510 Caxias do Sul";1135;100;9;154;1;771;2170
"430512 Cerrito";3;0;0;0;0;6;9
"430513 Cerro Branco";2;0;0;0;0;1;3
"430517 Cerro Grande do Sul";9;0;0;3;0;1;13
"430520 Cerro Largo";5;0;1;4;0;13;23
"430530 Chapada";6;0;0;0;0;2;8
"430535 Charqueadas";197;31;0;13;1;241;483
"430540 Chiapetta";1;0;0;0;0;3;4
"430543 Chuí";6;1;0;1;0;1;9
"430544 Chuvisca";1;0;0;0;0;0;1
"430545 Cidreira";38;2;0;0;0;54;94
"430550 Ciríaco";2;0;0;1;0;3;6
"430558 Colinas";3;0;0;0;0;1;4
"430560 Colorado";1;0;0;0;0;2;3
"430570 Condor";4;0;0;0;0;7;11
"430580 Constantina";5;0;0;2;3;4;14
"430583 Coqueiro Baixo";1;0;0;0;0;1;2
"430585 Coqueiros do Sul";0;0;0;0;0;1;1
"430587 Coronel Barros";2;0;0;0;0;2;4
"430590 Coronel Bicaco";15;0;0;0;0;9;24
"430593 Coronel Pilar";1;0;0;0;0;1;2
"430595 Cotiporã";4;0;0;1;0;2;7
"430597 Coxilha";3;1;0;0;0;0;4
"430600 Crissiumal";6;0;0;0;0;10;16
"430605 Cristal";3;0;0;0;0;4;7
"430610 Cruz Alta";248;19;0;60;0;344;671
"430613 Cruzaltense";1;0;0;0;0;0;1
"430620 Cruzeiro do Sul";16;4;0;2;0;5;27
"430630 David Canabarro";1;0;0;0;0;0;1
"430632 Derrubadas";2;0;0;2;0;2;6
"430635 Dezesseis de Novembro";0;0;0;0;0;1;1
"430637 Dilermando de Aguiar";6;0;1;0;0;2;9
"430640 Dois Irmãos";22;0;0;1;0;33;56
"430642 Dois Irmãos das Missões";0;0;0;0;0;1;1
"430645 Dois Lajeados";1;0;0;0;0;0;1
"430650 Dom Feliciano";5;0;0;0;0;6;11
"430660 Dom Pedrito";48;10;0;10;0;53;121
"430655 Dom Pedro de Alcântara";4;0;0;0;0;1;5
"430670 Dona Francisca";3;1;1;2;0;6;13
"430673 Doutor Maurício Cardoso";1;0;0;1;0;1;3
"430675 Doutor Ricardo";5;0;0;0;0;0;5
"430676 Eldorado do Sul";167;20;1;24;0;144;356
"430680 Encantado";31;7;0;3;0;27;68
"430690 Encruzilhada do Sul";27;2;0;7;0;25;61
"430692 Engenho Velho";1;0;0;0;0;1;2
"430695 Entre Rios do Sul";3;0;0;1;0;3;7
"430693 Entre-Ijuís";3;0;0;0;0;14;17
"430697 Erebango";0;0;0;0;0;2;2
"430700 Erechim";210;29;0;29;1;141;410
"430705 Ernestina";1;0;0;0;0;2;3
"430720 Erval Grande";2;0;0;0;0;1;3
"430730 Erval Seco";4;0;0;0;0;4;8
"430740 Esmeralda";1;0;0;0;0;3;4
"430750 Espumoso";37;1;0;3;0;9;50
"430755 Estação";4;1;0;0;0;5;10
"430760 Estância Velha";71;3;0;2;0;111;187
"430770 Esteio";247;38;2;28;0;370;685
"430780 Estrela";80;7;0;6;2;44;139
"430781 Estrela Velha";0;0;0;1;0;0;1
"430783 Eugênio de Castro";3;0;1;0;0;5;9
"430786 Fagundes Varela";3;0;0;1;0;0;4
"430790 Farroupilha";110;11;0;5;0;97;223
"430800 Faxinal do Soturno";6;2;1;1;0;4;14
"430805 Faxinalzinho";1;0;0;0;0;1;2
"430807 Fazenda Vilanova";8;1;0;2;0;2;13
"430810 Feliz";22;0;0;0;0;17;39
"430820 Flores da Cunha";37;4;0;3;0;30;74
"430825 Floriano Peixoto";1;0;0;0;0;0;1
"430830 Fontoura Xavier";8;0;0;1;0;0;9
"430840 Formigueiro";2;1;0;0;0;2;5
"430843 Forquetinha";1;0;0;0;0;0;1
"430845 Fortaleza dos Valos";3;0;0;0;0;5;8
"430850 Frederico Westphalen";26;0;1;4;0;23;54
"430860 Garibaldi";62;3;0;12;0;35;112
"430865 Garruchos";0;0;0;0;0;2;2
"430870 Gaurama";4;0;0;1;0;1;6
"430880 General Câmara";12;1;0;0;0;12;25
"430885 Gentil";0;0;0;0;0;1;1
"430890 Getúlio Vargas";7;0;0;2;0;14;23
"430900 Giruá";24;0;0;2;0;25;51
"430905 Glorinha";6;1;0;1;0;10;18
"430910 Gramado";74;3;2;4;0;48;131
"430912 Gramado dos Loureiros";2;0;0;0;0;0;2
"430915 Gramado Xavier";2;0;0;0;0;1;3
"430920 Gravataí";942;132;3;93;0;1000;2170
"430925 Guabiju";3;0;0;0;0;0;3
"430930 Guaíba";498;77;1;68;1;320;965
"430940 Guaporé";33;3;0;10;0;33;79
"430950 Guarani das Missões";7;0;0;0;0;13;20
"430955 Harmonia";10;0;0;0;0;5;15
"430710 Herval";6;0;0;2;0;10;18
"430957 Herveiras";3;0;0;0;0;0;3
"430960 Horizontina";17;2;0;0;0;14;33
"430965 Hulha Negra";1;2;0;0;0;0;3
"430970 Humaitá";0;0;0;0;0;1;1
"430975 Ibarama";1;0;0;1;0;1;3
"430980 Ibiaçá";2;0;0;1;0;1;4
"430990 Ibiraiaras";5;1;0;0;0;0;6
"430995 Ibirapuitã";2;0;0;0;0;3;5
"431000 Ibirubá";19;0;1;8;0;22;50
"431010 Igrejinha";66;2;0;1;0;79;148
"431020 Ijuí";122;4;0;3;0;117;246
"431030 Ilópolis";8;0;0;0;0;1;9
"431033 Imbé";45;1;0;5;0;89;140
"431036 Imigrante";2;0;0;0;0;1;3
"431040 Independência";6;0;0;2;0;6;14
"431043 Ipê";4;0;0;1;0;1;6
"431046 Ipiranga do Sul";1;0;0;0;0;0;1
"431050 Iraí";5;0;0;2;0;5;12
"431053 Itaara";11;0;0;2;0;8;21
"431055 Itacurubi";1;0;0;1;0;2;4
"431060 Itaqui";106;9;0;30;0;195;340
"431065 Itati";0;0;0;0;0;2;2
"431070 Itatiba do Sul";2;0;0;0;0;0;2
"431075 Ivorá";1;0;0;0;0;0;1
"431080 Ivoti";34;3;0;1;1;35;74
"431085 Jaboticaba";1;0;0;0;0;0;1
"431087 Jacuizinho";3;0;0;0;0;0;3
"431090 Jacutinga";3;0;1;0;0;2;6
"431100 Jaguarão";51;6;1;6;0;66;130
"431110 Jaguari";11;1;1;2;0;10;25
"431112 Jaquirana";2;0;0;1;0;3;6
"431113 Jari";6;0;0;0;0;1;7
"431115 Jóia";3;0;0;0;0;3;6
"431120 Júlio de Castilhos";24;0;1;7;0;18;50
"431123 Lagoa Bonita do Sul";2;0;0;0;0;0;2
"431127 Lagoa dos Três Cantos";2;0;0;0;0;1;3
"431130 Lagoa Vermelha";131;5;1;19;1;76;233
"431125 Lagoão";4;0;0;1;0;0;5
"431140 Lajeado";216;48;0;15;0;119;398
"431142 Lajeado do Bugre";1;0;0;0;0;1;2
"431150 Lavras do Sul";4;5;0;1;0;6;16
"431160 Liberato Salzano";0;0;0;0;0;3;3
"431162 Lindolfo Collor";12;1;0;0;0;3;16
"431164 Linha Nova";1;0;0;0;0;0;1
"431171 Maçambara";5;0;0;1;0;2;8
"431170 Machadinho";7;1;0;1;0;1;10
"431173 Mampituba";1;0;0;0;0;0;1
"431175 Manoel Viana";18;0;0;1;0;2;21
"431177 Maquiné";5;0;0;1;0;5;11
"431180 Marau";35;2;0;9;0;19;65
"431190 Marcelino Ramos";0;0;0;0;0;2;2
"431198 Mariana Pimentel";7;1;0;0;0;1;9
"431200 Mariano Moro";3;0;0;0;0;0;3
"431205 Marques de Souza";4;0;0;0;0;0;4
"431210 Mata";3;0;0;0;0;8;11
"431213 Mato Castelhano";1;0;0;1;0;1;3
"431215 Mato Leitão";0;1;0;0;0;1;2
"431217 Mato Queimado";1;0;0;0;0;2;3
"431220 Maximiliano de Almeida";11;1;0;1;0;0;13
"431225 Minas do Leão";13;0;0;1;0;22;36
"431230 Miraguaí";3;0;0;0;0;5;8
"431235 Montauri";1;0;0;0;0;0;1
"431237 Monte Alegre dos Campos";0;0;0;3;0;0;3
"431238 Monte Belo do Sul";5;0;0;0;0;0;5
"431240 Montenegro";228;38;1;7;2;194;470
"431242 Mormaço";1;0;0;0;0;1;2
"431244 Morrinhos do Sul";1;0;0;0;0;1;2
"431245 Morro Redondo";3;0;0;0;0;6;9
"431247 Morro Reuter";2;0;0;0;0;8;10
"431250 Mostardas";17;3;0;2;0;18;40
"431260 Muçum";5;0;0;2;0;6;13
"431261 Muitos Capões";3;0;0;0;0;0;3
"431262 Muliterno";1;0;0;0;0;0;1
"431265 Não-Me-Toque";8;2;1;9;0;13;33
"431267 Nicolau Vergueiro";0;0;0;0;0;2;2
"431270 Nonoai";18;2;0;1;1;9;31
"431275 Nova Alvorada";1;0;0;0;0;0;1
"431280 Nova Araçá";5;0;0;0;0;1;6
"431290 Nova Bassano";7;1;0;1;0;4;13
"431300 Nova Bréscia";7;0;0;0;0;1;8
"431303 Nova Esperança do Sul";5;0;0;0;0;2;7
"431306 Nova Hartz";23;1;0;4;0;9;37
"431308 Nova Pádua";1;0;0;0;0;2;3
"431310 Nova Palma";4;0;0;0;0;2;6
"431320 Nova Petrópolis";24;1;0;0;0;14;39
"431330 Nova Prata";41;5;0;12;0;21;79
"431333 Nova Ramada";1;0;0;0;0;0;1
"431335 Nova Roma do Sul";1;0;0;0;0;1;2
"431337 Nova Santa Rita";37;0;1;1;0;59;98
"431349 Novo Barreiro";0;0;0;1;0;2;3
"431339 Novo Cabrais";2;0;0;0;0;1;3
"431340 Novo Hamburgo";1042;76;5;30;2;923;2078
"431342 Novo Machado";0;0;0;0;0;3;3
"431344 Novo Tiradentes";2;0;0;0;0;0;2
"431346 Novo Xingu";2;0;0;0;0;0;2
"431350 Osório";158;20;1;9;0;182;370
"431360 Paim Filho";1;0;0;0;0;1;2
"431365 Palmares do Sul";35;3;0;2;0;39;79
"431370 Palmeira das Missões";86;7;0;14;1;69;177
"431380 Palmitinho";5;0;0;1;0;2;8
"431390 Panambi";31;3;0;3;0;45;82
"431395 Pantano Grande";32;5;0;7;0;16;60
"431400 Paraí";4;0;0;0;0;1;5
"431402 Paraíso do Sul";4;1;0;0;0;4;9
"431403 Pareci Novo";5;0;0;0;0;5;10
"431405 Parobé";123;3;0;3;0;98;227
"431407 Passo do Sobrado";4;6;0;1;0;2;13
"431410 Passo Fundo";690;41;4;87;2;552;1376
"431413 Paulo Bento";1;0;0;0;0;0;1
"431415 Paverama";8;0;0;2;0;9;19
"431417 Pedras Altas";0;1;0;0;0;0;1
"431420 Pedro Osório";10;1;0;0;0;16;27
"431430 Pejuçara";1;0;0;0;0;6;7
"431440 Pelotas";672;164;3;91;1;1738;2669
"431442 Picada Café";6;0;0;1;0;2;9
"431445 Pinhal";6;0;0;4;0;20;30
"431446 Pinhal da Serra";0;0;0;1;0;0;1
"431447 Pinhal Grande";6;0;0;1;0;0;7
"431450 Pinheiro Machado";10;2;0;2;0;22;36
"431460 Piratini";5;2;0;1;0;12;20
"431470 Planalto";10;0;0;0;0;3;13
"431475 Poço das Antas";2;0;0;0;0;0;2
"431477 Pontão";6;0;0;0;0;1;7
"431480 Portão";57;1;0;1;0;76;135
"431490 Porto Alegre";12854;3930;26;2368;53;10534;29765
"431500 Porto Lucena";1;0;0;0;0;2;3
"431505 Porto Mauá";0;0;0;1;0;1;2
"431510 Porto Xavier";3;0;0;0;0;14;17
"431513 Pouso Novo";6;0;0;0;0;1;7
"431514 Presidente Lucena";0;0;0;0;0;1;1
"431515 Progresso";2;0;0;0;0;0;2
"431520 Putinga";1;0;0;0;0;2;3
"431530 Quaraí";22;0;0;7;1;36;66
"431531 Quatro Irmãos";1;0;0;0;0;0;1
"431535 Quinze de Novembro";3;0;0;0;0;1;4
"431540 Redentora";3;0;0;1;0;3;7
"431550 Restinga Seca";26;7;1;8;0;10;52
"431555 Rio dos Índios";4;0;0;0;0;1;5
"431560 Rio Grande";1148;244;4;92;0;1075;2563
"431570 Rio Pardo";66;15;0;12;0;38;131
"431575 Riozinho";3;0;0;0;0;0;3
"431580 Roca Sales";13;0;0;0;0;5;18
"431590 Rodeio Bonito";7;0;0;1;0;2;10
"431595 Rolador";0;0;0;0;0;1;1
"431600 Rolante";19;0;1;1;0;28;49
"431610 Ronda Alta";7;0;0;1;2;7;17
"431620 Rondinha";4;0;0;1;0;7;12
"431630 Roque Gonzales";1;0;0;0;0;5;6
"431640 Rosário do Sul";66;6;0;7;1;85;165
"431642 Sagrada Família";2;0;0;0;0;1;3
"431643 Saldanha Marinho";1;0;0;0;0;0;1
"431645 Salto do Jacuí";11;0;0;2;1;14;28
"431647 Salvador das Missões";1;0;0;0;0;0;1
"431650 Salvador do Sul";9;0;0;1;0;6;16
"431660 Sananduva";12;0;0;1;0;4;17
"431670 Santa Bárbara do Sul";2;0;0;2;0;10;14
"431673 Santa Cecília do Sul";3;0;0;1;0;0;4
"431675 Santa Clara do Sul";4;0;0;0;0;1;5
"431680 Santa Cruz do Sul";395;71;1;74;1;230;772
"431697 Santa Margarida do Sul";6;0;0;0;0;1;7
"431690 Santa Maria";1000;131;27;148;3;850;2159
"431695 Santa Maria do Herval";3;0;0;0;0;3;6
"431720 Santa Rosa";106;2;0;12;0;98;218
"431730 Santa Vitória do Palmar";108;23;1;10;0;60;202
"431700 Santana da Boa Vista";2;0;0;0;0;2;4
"431710 Santana do Livramento";160;29;0;15;0;109;313
"431740 Santiago";113;8;0;16;1;104;242
"431750 Santo Ângelo";108;0;2;10;0;265;385
"431760 Santo Antônio da Patrulha";94;19;0;14;1;70;198
"431770 Santo Antônio das Missões";4;0;0;0;0;6;10
"431755 Santo Antônio do Palma";1;0;0;0;0;1;2
"431775 Santo Antônio do Planalto";1;0;0;0;0;2;3
"431780 Santo Augusto";7;0;0;0;0;10;17
"431790 Santo Cristo";7;0;0;0;0;6;13
"431795 Santo Expedito do Sul";2;0;0;2;0;1;5
"431800 São Borja";165;5;0;26;0;197;393
"431805 São Domingos do Sul";5;0;0;0;0;2;7
"431810 São Francisco de Assis";18;0;1;10;0;10;39
"431820 São Francisco de Paula";27;4;0;2;0;40;73
"431830 São Gabriel";112;10;0;19;0;102;243
"431840 São Jerônimo";36;8;0;3;1;59;107
"431843 São João do Polêsine";4;0;0;0;0;0;4
"431844 São Jorge";0;0;0;1;0;0;1
"431845 São José das Missões";2;0;0;0;0;1;3
"431846 São José do Herval";0;0;0;1;0;1;2
"431848 São José do Hortêncio";2;0;0;1;0;1;4
"431850 São José do Norte";39;10;0;2;0;32;83
"431860 São José do Ouro";6;0;0;1;0;5;12
"431861 São José do Sul";2;0;0;0;0;1;3
"431862 São José dos Ausentes";0;0;0;1;0;2;3
"431870 São Leopoldo";1441;120;3;99;8;1187;2858
"431880 São Lourenço do Sul";27;11;0;3;0;48;89
"431890 São Luiz Gonzaga";39;0;0;1;0;112;152
"431900 São Marcos";36;2;0;2;0;21;61
"431910 São Martinho";0;0;0;0;0;5;5
"431912 São Martinho da Serra";2;1;0;0;0;4;7
"431915 São Miguel das Missões";0;0;0;0;0;3;3
"431920 São Nicolau";6;0;0;0;0;6;12
"431930 São Paulo das Missões";0;0;0;0;0;3;3
"431935 São Pedro da Serra";3;0;0;0;0;0;3
"431936 São Pedro das Missões";0;1;0;0;0;1;2
"431937 São Pedro do Butiá";0;0;0;0;0;2;2
"431940 São Pedro do Sul";35;4;0;3;0;19;61
"431950 São Sebastião do Caí";79;3;1;5;0;84;172
"431960 São Sepé";32;9;0;8;0;24;73
"431970 São Valentim";1;0;0;0;0;3;4
"431971 São Valentim do Sul";3;0;0;1;0;3;7
"431973 São Valério do Sul";1;0;0;0;0;1;2
"431980 São Vicente do Sul";11;2;0;3;0;13;29
"431990 Sapiranga";178;8;3;9;1;120;319
"432000 Sapucaia do Sul";483;52;0;49;0;719;1303
"432010 Sarandi";18;3;0;8;0;10;39
"432020 Seberi";6;0;1;0;0;5;12
"432023 Sede Nova";1;0;0;0;0;5;6
"432026 Segredo";0;0;0;1;0;4;5
"432030 Selbach";3;1;0;0;0;3;7
"432032 Senador Salgado Filho";2;0;0;2;0;0;4
"432035 Sentinela do Sul";8;1;0;1;0;6;16
"432040 Serafina Corrêa";25;1;0;2;0;8;36
"432045 Sério";2;0;0;0;0;0;2
"432050 Sertão";2;1;0;3;0;2;8
"432055 Sertão Santana";4;1;0;1;0;2;8
"432057 Sete de Setembro";1;0;0;0;0;1;2
"432060 Severiano de Almeida";3;0;0;0;0;1;4
"432065 Silveira Martins";3;2;0;0;0;2;7
"432067 Sinimbu";6;1;0;2;0;1;10
"432070 Sobradinho";25;1;0;9;0;21;56
"432080 Soledade";51;2;2;10;0;33;98
"432085 Tabaí";6;0;0;0;0;1;7
"432090 Tapejara";28;3;0;5;0;10;46
"432100 Tapera";20;0;0;0;0;6;26
"432110 Tapes";52;14;0;11;0;47;124
"432120 Taquara";96;11;0;15;0;177;299
"432130 Taquari";38;1;0;6;0;35;80
"432135 Tavares";12;0;0;1;0;7;20
"432140 Tenente Portela";14;0;1;0;1;16;32
"432143 Terra de Areia";10;1;0;0;0;10;21
"432145 Teutônia";40;2;0;1;0;13;56
"432146 Tio Hugo";0;0;0;1;0;0;1
"432147 Tiradentes do Sul";3;0;0;0;0;3;6
"432149 Toropi";1;0;0;0;0;0;1
"432150 Torres";277;12;0;10;5;148;452
"432160 Tramandaí";217;23;0;14;0;339;593
"432166 Três Cachoeiras";19;1;0;0;0;8;28
"432170 Três Coroas";30;1;0;2;0;29;62
"432180 Três de Maio";23;0;0;4;0;30;57
"432183 Três Forquilhas";2;0;0;1;0;0;3
"432185 Três Palmeiras";3;0;0;2;0;1;6
"432190 Três Passos";30;3;0;1;0;39;73
"432195 Trindade do Sul";6;0;0;1;0;2;9
"432200 Triunfo";28;3;0;2;0;26;59
"432210 Tucunduva";3;0;1;1;0;5;10
"432215 Tunas";1;0;0;0;0;0;1
"432220 Tupanciretã";31;1;2;6;0;19;59
"432225 Tupandi";4;0;0;0;0;1;5
"432230 Tuparendi";7;0;0;0;0;8;15
"432232 Turuçu";2;1;0;0;0;5;8
"432234 Ubiretama";0;0;0;0;0;1;1
"432237 Unistalda";2;1;0;0;0;3;6
"432240 Uruguaiana";371;59;2;110;2;955;1499
"432250 Vacaria";130;10;5;94;1;135;375
"432253 Vale do Sol";7;1;0;1;0;0;9
"432254 Vale Real";5;0;0;1;0;4;10
"432252 Vale Verde";2;0;0;0;0;0;2
"432255 Vanini";3;0;0;0;0;0;3
"432260 Venâncio Aires";137;23;3;26;0;77;266
"432270 Vera Cruz";26;4;1;4;0;19;54
"432280 Veranópolis";59;2;0;20;0;20;101
"432285 Vespasiano Correa";1;0;0;0;0;0;1
"432290 Viadutos";0;0;0;0;0;1;1
"432300 Viamão";1147;329;6;196;2;1295;2975
"432310 Vicente Dutra";2;0;0;0;0;3;5
"432320 Victor Graeff";1;0;0;0;0;3;4
"432330 Vila Flores";2;0;0;0;0;3;5
"432340 Vila Maria";4;0;0;0;0;1;5
"432345 Vila Nova do Sul";4;0;0;1;0;1;6
"432350 Vista Alegre";0;0;0;0;0;1;1
"432375 Vitória das Missões";1;0;0;0;0;3;4
"432377 Westfalia";1;0;0;0;0;1;2
"432380 Xangri-lá";63;7;0;7;0;32;109
"430000 Município ignorado - RS";5;0;0;0;0;1;6
"500020 Água Clara";10;1;0;7;0;34;52
"500025 Alcinópolis";3;3;0;10;0;0;16
"500060 Amambaí";27;0;0;16;11;37;91
"500070 Anastácio";7;0;1;13;5;25;51
"500080 Anaurilândia";0;0;0;1;0;3;4
"500085 Angélica";4;1;0;2;0;3;10
"500090 Antônio João";2;0;0;2;0;4;8
"500100 Aparecida do Taboado";18;4;0;8;0;47;77
"500110 Aquidauana";21;6;1;22;6;78;134
"500124 Aral Moreira";2;0;0;2;0;5;9
"500150 Bandeirantes";6;3;0;8;0;5;22
"500190 Bataguassu";8;4;0;6;0;25;43
"500200 Batayporã";5;2;0;0;0;12;19
"500210 Bela Vista";16;0;0;18;0;16;50
"500215 Bodoquena";0;0;0;4;1;4;9
"500220 Bonito";6;0;0;5;2;11;24
"500230 Brasilândia";2;2;0;2;0;20;26
"500240 Caarapó";7;1;0;5;4;26;43
"500260 Camapuã";7;2;0;7;0;10;26
"500270 Campo Grande";1588;194;58;970;13;2122;4945
"500280 Caracol";3;0;0;2;0;5;10
"500290 Cassilândia";20;6;1;11;0;27;65
"500295 Chapadão do Sul";17;2;0;11;0;21;51
"500310 Corguinho";2;0;0;0;0;0;2
"500315 Coronel Sapucaia";3;1;0;8;4;14;30
"500320 Corumbá";44;12;1;133;4;285;479
"500325 Costa Rica";21;2;0;18;0;20;61
"500330 Coxim";20;5;1;23;0;39;88
"500345 Deodápolis";4;0;0;3;0;5;12
"500348 Dois Irmãos do Buriti";7;1;0;10;0;4;22
"500350 Douradina";0;1;0;1;0;2;4
"500370 Dourados";235;22;2;167;17;461;904
"500375 Eldorado";13;0;0;8;0;20;41
"500380 Fátima do Sul";5;1;0;6;0;16;28
"500390 Figueirão";2;1;0;1;0;2;6
"500400 Glória de Dourados";2;0;0;3;0;8;13
"500410 Guia Lopes da Laguna";4;0;0;4;0;5;13
"500430 Iguatemi";8;2;0;13;6;17;46
"500440 Inocência";5;1;0;3;0;7;16
"500450 Itaporã";3;0;0;9;0;6;18
"500460 Itaquiraí";7;0;0;8;0;5;20
"500470 Ivinhema";5;0;0;5;0;19;29
"500480 Japorã";2;0;0;1;4;7;14
"500490 Jaraguari";1;1;0;1;1;1;5
"500500 Jardim";23;4;0;17;2;28;74
"500510 Jateí";0;0;0;1;0;1;2
"500515 Juti";2;1;0;0;0;7;10
"500520 Ladário";6;4;0;16;0;27;53
"500525 Laguna Carapã";0;0;0;2;0;4;6
"500540 Maracaju";29;6;1;19;0;21;76
"500560 Miranda";21;1;1;19;5;23;70
"500568 Mundo Novo";17;1;0;8;0;14;40
"500570 Naviraí";34;4;0;40;2;63;143
"500580 Nioaque";8;0;0;6;0;5;19
"500600 Nova Alvorada do Sul";5;2;0;11;0;5;23
"500620 Nova Andradina";12;0;1;12;0;64;89
"500625 Novo Horizonte do Sul";3;0;0;2;0;1;6
"500630 Paranaíba";33;8;0;19;0;85;145
"500635 Paranhos";5;1;0;3;1;8;18
"500640 Pedro Gomes";4;0;0;2;0;5;11
"500660 Ponta Porã";67;3;2;69;3;185;329
"500690 Porto Murtinho";7;1;0;3;0;12;23
"500710 Ribas do Rio Pardo";15;7;0;19;0;26;67
"500720 Rio Brilhante";17;3;0;8;1;57;86
"500730 Rio Negro";8;1;0;3;0;9;21
"500740 Rio Verde de Mato Grosso";25;13;0;53;0;35;126
"500750 Rochedo";1;1;0;3;0;1;6
"500755 Santa Rita do Pardo";2;0;0;0;0;3;5
"500769 São Gabriel do Oeste";22;4;0;24;0;23;73
"500780 Selvíria";1;0;0;1;0;9;11
"500770 Sete Quedas";5;0;0;3;0;13;21
"500790 Sidrolândia";35;4;0;32;1;34;106
"500793 Sonora";8;5;0;25;0;18;56
"500795 Tacuru";0;1;0;0;1;7;9
"500797 Taquarussu";0;0;0;0;0;2;2
"500800 Terenos";11;3;0;3;0;9;26
"500830 Três Lagoas";67;7;1;70;1;300;446
"500840 Vicentina";0;2;0;1;0;2;5
"510010 Acorizal";3;0;0;12;0;7;22
"510020 Água Boa";12;1;0;16;0;9;38
"510025 Alta Floresta";34;9;0;28;0;66;137
"510030 Alto Araguaia";10;6;2;18;0;11;47
"510035 Alto Boa Vista";1;0;0;2;0;1;4
"510040 Alto Garças";3;3;1;5;0;12;24
"510050 Alto Paraguai";2;0;0;8;0;5;15
"510060 Alto Taquari";3;0;0;5;0;1;9
"510080 Apiacás";1;3;0;4;0;10;18
"510100 Araguaiana";0;0;0;1;0;1;2
"510120 Araguainha";2;0;0;4;0;2;8
"510125 Araputanga";1;0;0;9;0;10;20
"510130 Arenápolis";5;3;0;10;0;16;34
"510140 Aripuanã";7;0;0;18;0;13;38
"510160 Barão de Melgaço";0;0;0;1;0;3;4
"510170 Barra do Bugres";15;9;1;22;0;38;85
"510180 Barra do Garças";60;6;1;62;0;63;192
"510185 Bom Jesus do Araguaia";2;0;0;1;0;0;3
"510190 Brasnorte";6;4;0;9;3;11;33
"510250 Cáceres";47;20;1;128;0;94;290
"510260 Campinápolis";1;0;0;0;0;2;3
"510263 Campo Novo do Parecis";26;10;0;35;0;20;91
"510267 Campo Verde";16;2;1;20;0;17;56
"510268 Campos de Júlio";4;2;0;4;0;4;14
"510269 Canabrava do Norte";1;0;0;0;0;2;3
"510270 Canarana";12;3;0;15;0;4;34
"510279 Carlinda";3;0;0;2;0;2;7
"510285 Castanheira";2;0;0;3;0;1;6
"510300 Chapada dos Guimarães";4;6;0;15;0;15;40
"510305 Cláudia";4;1;0;2;0;8;15
"510310 Cocalinho";0;0;0;2;0;1;3
"510320 Colíder";10;3;0;9;0;21;43
"510325 Colniza";6;1;0;1;0;2;10
"510330 Comodoro";10;1;0;13;0;11;35
"510335 Confresa";12;7;1;20;0;7;47
"510336 Conquista D'Oeste";0;1;0;2;0;0;3
"510337 Cotriguaçu";1;1;0;7;0;2;11
"510340 Cuiabá";479;187;33;1122;7;2296;4124
"510343 Curvelândia";0;0;0;2;0;1;3
"510345 Denise";4;1;0;8;0;6;19
"510350 Diamantino";10;5;0;14;0;22;51
"510360 Dom Aquino";8;0;0;3;0;8;19
"510370 Feliz Natal";3;0;0;3;0;9;15
"510380 Figueirópolis D'Oeste";0;0;0;1;0;2;3
"510385 Gaúcha do Norte";1;1;0;2;0;0;4
"510390 General Carneiro";4;1;0;2;1;0;8
"510395 Glória D'Oeste";0;0;0;1;0;0;1
"510410 Guarantã do Norte";9;4;0;18;0;30;61
"510420 Guiratinga";2;1;0;10;0;11;24
"510450 Indiavaí";3;3;0;2;1;1;10
"510452 Ipiranga do Norte";1;0;0;1;0;1;3
"510454 Itanhangá";1;0;0;3;0;1;5
"510455 Itaúba";1;0;0;2;0;2;5
"510460 Itiquira";8;1;1;8;0;12;30
"510480 Jaciara";36;5;1;19;0;53;114
"510490 Jangada";2;0;0;9;0;7;18
"510500 Jauru";3;2;0;6;0;4;15
"510510 Juara";45;3;1;32;0;39;120
"510515 Juína";63;15;0;36;0;19;133
"510517 Juruena";3;3;0;3;0;2;11
"510520 Juscimeira";8;4;0;6;0;11;29
"510523 Lambari D'Oeste";1;1;0;2;0;0;4
"510525 Lucas do Rio Verde";25;10;1;35;0;40;111
"510530 Luciára";0;0;0;0;0;1;1
"510558 Marcelândia";5;3;0;4;0;12;24
"510560 Matupá";5;1;0;3;0;13;22
"510562 Mirassol d'Oeste";11;4;0;13;0;10;38
"510590 Nobres";13;6;0;21;0;24;64
"510600 Nortelândia";2;1;0;1;0;8;12
"510610 Nossa Senhora do Livramento";3;2;0;3;0;6;14
"510615 Nova Bandeirantes";2;2;0;0;0;3;7
"510620 Nova Brasilândia";2;0;0;3;0;4;9
"510621 Nova Canaã do Norte";0;0;0;3;0;4;7
"510880 Nova Guarita";0;0;0;1;0;4;5
"510618 Nova Lacerda";0;0;0;3;0;4;7
"510885 Nova Marilândia";1;1;0;1;0;0;3
"510890 Nova Maringá";2;0;0;4;0;5;11
"510895 Nova Monte Verde";3;0;0;2;0;3;8
"510622 Nova Mutum";17;7;1;34;0;18;77
"510623 Nova Olímpia";5;4;2;11;0;15;37
"510619 Nova Santa Helena";1;0;0;0;0;1;2
"510624 Nova Ubiratã";4;2;0;3;0;4;13
"510625 Nova Xavantina";2;1;0;4;0;10;17
"510627 Novo Horizonte do Norte";0;0;0;0;0;1;1
"510626 Novo Mundo";3;2;0;6;0;5;16
"510631 Novo Santo Antônio";0;0;0;1;0;1;2
"510628 Novo São Joaquim";0;0;0;4;0;1;5
"510629 Paranaíta";5;0;0;3;0;17;25
"510630 Paranatinga";17;8;2;15;0;18;60
"510637 Pedra Preta";6;2;2;9;0;5;24
"510642 Peixoto de Azevedo";13;6;0;18;0;38;75
"510645 Planalto da Serra";0;1;0;1;0;2;4
"510650 Poconé";5;6;0;20;0;27;58
"510665 Pontal do Araguaia";0;0;0;5;0;4;9
"510670 Ponte Branca";0;0;0;1;0;0;1
"510675 Pontes e Lacerda";22;8;0;31;1;25;87
"510677 Porto Alegre do Norte";0;0;0;4;0;2;6
"510680 Porto dos Gaúchos";4;0;0;0;0;2;6
"510682 Porto Esperidião";2;1;0;6;0;6;15
"510685 Porto Estrela";1;0;0;4;0;1;6
"510700 Poxoréo";13;8;3;16;0;25;65
"510704 Primavera do Leste";52;16;8;67;1;52;196
"510706 Querência";8;0;0;8;0;4;20
"510718 Ribeirão Cascalheira";1;1;0;3;0;1;6
"510719 Ribeirãozinho";0;0;0;0;0;1;1
"510720 Rio Branco";3;0;0;5;0;3;11
"510757 Rondolândia";0;1;0;3;0;0;4
"510760 Rondonópolis";374;81;13;298;2;498;1266
"510770 Rosário Oeste";7;2;0;18;0;19;46
"510775 Salto do Céu";1;0;0;2;0;3;6
"510724 Santa Carmem";2;0;0;3;0;4;9
"510774 Santa Cruz do Xingu";0;1;0;2;0;1;4
"510776 Santa Rita do Trivelato";0;0;0;1;0;1;2
"510777 Santa Terezinha";1;0;0;1;5;2;9
"510726 Santo Afonso";1;0;0;0;0;2;3
"510779 Santo Antônio do Leste";2;0;0;2;0;1;5
"510780 Santo Antônio do Leverger";4;6;0;17;0;18;45
"510785 São Félix do Araguaia";1;0;0;4;3;5;13
"510729 São José do Povo";2;0;0;0;0;0;2
"510730 São José do Rio Claro";10;2;0;13;0;8;33
"510735 São José do Xingu";0;0;0;1;0;0;1
"510710 São José dos Quatro Marcos";6;3;0;7;0;5;21
"510740 São Pedro da Cipa";3;0;0;4;0;2;9
"510787 Sapezal";17;1;0;27;0;25;70
"510790 Sinop";98;20;1;107;1;181;408
"510792 Sorriso";63;22;3;77;0;80;245
"510794 Tabaporã";8;0;0;4;0;5;17
"510795 Tangará da Serra";90;26;1;67;2;100;286
"510800 Tapurah";8;2;0;11;1;6;28
"510805 Terra Nova do Norte";3;0;0;2;0;4;9
"510810 Tesouro";1;2;1;5;0;8;17
"510820 Torixoréu";0;3;0;1;0;1;5
"510830 União do Sul";1;0;0;3;0;0;4
"510835 Vale de São Domingos";0;0;0;1;0;5;6
"510840 Várzea Grande";195;85;4;420;0;619;1323
"510850 Vera";8;2;0;7;0;8;25
"510550 Vila Bela da Santíssima Trindade";0;0;0;6;0;3;9
"510860 Vila Rica";12;0;0;20;0;14;46
"510000 Município ignorado - MT";1;0;0;0;0;1;2
"520005 Abadia de Goiás";2;2;0;4;0;5;13
"520010 Abadiânia";5;0;0;9;0;7;21
"520013 Acreúna";2;0;0;8;0;16;26
"520015 Adelândia";0;0;0;1;0;2;3
"520017 Água Fria de Goiás";0;0;0;3;0;3;6
"520020 Água Limpa";1;0;0;2;0;1;4
"520025 Águas Lindas de Goiás";45;12;3;101;0;86;247
"520030 Alexânia";4;3;0;10;0;14;31
"520050 Aloândia";1;0;0;1;0;1;3
"520055 Alto Horizonte";0;0;0;3;0;1;4
"520060 Alto Paraíso de Goiás";3;1;0;2;1;5;12
"520080 Alvorada do Norte";1;2;1;7;0;5;16
"520082 Amaralina";0;0;0;1;0;1;2
"520085 Americano do Brasil";2;0;0;0;0;2;4
"520090 Amorinópolis";0;0;0;0;0;1;1
"520110 Anápolis";214;26;4;378;4;490;1116
"520120 Anhanguera";0;0;0;0;0;1;1
"520130 Anicuns";2;1;0;12;0;12;27
"520140 Aparecida de Goiânia";152;55;5;593;2;716;1523
"520145 Aparecida do Rio Doce";1;0;0;0;0;1;2
"520150 Aporé";0;0;0;2;0;0;2
"520160 Araçu";1;0;0;0;0;2;3
"520170 Aragarças";6;2;2;26;0;17;53
"520180 Aragoiânia";3;0;0;3;0;9;15
"520215 Araguapaz";1;0;0;1;0;3;5
"520235 Arenópolis";0;0;0;3;0;1;4
"520250 Aruanã";0;0;0;5;0;4;9
"520260 Aurilândia";0;0;0;1;0;4;5
"520280 Avelinópolis";0;0;0;2;0;0;2
"520310 Baliza";0;0;0;1;0;0;1
"520320 Barro Alto";0;1;0;1;0;1;3
"520330 Bela Vista de Goiás";4;1;0;24;0;22;51
"520340 Bom Jardim de Goiás";0;1;0;4;0;1;6
"520350 Bom Jesus de Goiás";5;2;0;15;0;30;52
"520355 Bonfinópolis";2;1;0;10;0;5;18
"520360 Brazabrantes";0;0;0;1;0;1;2
"520380 Britânia";2;0;0;4;0;3;9
"520390 Buriti Alegre";5;1;0;5;0;11;22
"520400 Cabeceiras";2;1;0;5;0;3;11
"520410 Cachoeira Alta";0;0;0;6;0;8;14
"520420 Cachoeira de Goiás";0;0;0;1;0;0;1
"520425 Cachoeira Dourada";2;0;0;3;0;8;13
"520430 Caçu";1;0;0;9;0;12;22
"520440 Caiapônia";2;2;0;7;0;15;26
"520450 Caldas Novas";45;6;1;113;1;139;305
"520455 Caldazinha";0;0;0;3;0;4;7
"520460 Campestre de Goiás";1;0;0;1;0;7;9
"520465 Campinaçu";0;0;0;1;0;3;4
"520470 Campinorte";1;0;0;5;0;4;10
"520480 Campo Alegre de Goiás";1;0;0;1;0;2;4
"520485 Campo Limpo de Goiás";1;0;0;2;0;1;4
"520490 Campos Belos";5;2;0;7;0;11;25
"520495 Campos Verdes";0;1;0;3;0;5;9
"520500 Carmo do Rio Verde";0;0;0;4;0;6;10
"520505 Castelândia";0;0;0;3;0;6;9
"520510 Catalão";42;8;0;47;0;87;184
"520520 Caturaí";0;0;0;2;0;1;3
"520530 Cavalcante";1;0;0;3;0;2;6
"520540 Ceres";3;2;0;13;0;18;36
"520545 Cezarina";1;0;0;10;0;11;22
"520547 Chapadão do Céu";2;0;0;3;0;6;11
"520549 Cidade Ocidental";28;8;0;37;0;71;144
"520551 Cocalzinho de Goiás";2;1;0;5;0;4;12
"520552 Colinas do Sul";0;0;0;1;0;1;2
"520580 Corumbá de Goiás";0;0;0;1;0;4;5
"520590 Corumbaíba";5;1;0;14;0;22;42
"520620 Cristalina";6;3;0;23;0;43;75
"520630 Cristianópolis";0;0;0;2;0;2;4
"520640 Crixás";1;0;0;9;0;5;15
"520650 Cromínia";0;0;0;0;0;1;1
"520660 Cumari";0;0;0;1;0;1;2
"520680 Damolândia";0;0;0;1;0;3;4
"520690 Davinópolis";1;0;0;2;0;2;5
"520710 Diorama";2;0;0;1;0;0;3
"520830 Divinópolis de Goiás";0;0;0;1;0;0;1
"520725 Doverlândia";1;0;0;2;0;2;5
"520735 Edealina";0;0;0;1;0;2;3
"520740 Edéia";3;0;0;8;0;10;21
"520750 Estrela do Norte";1;0;0;0;0;1;2
"520753 Faina";0;0;0;2;0;13;15
"520760 Fazenda Nova";0;0;0;0;0;3;3
"520780 Firminópolis";1;0;0;3;0;6;10
"520790 Flores de Goiás";0;1;0;0;0;2;3
"520800 Formosa";26;9;1;44;0;55;135
"520810 Formoso";0;0;0;5;0;2;7
"520815 Gameleira de Goiás";1;0;0;0;0;2;3
"520840 Goianápolis";3;0;0;8;0;10;21
"520850 Goiandira";1;0;0;2;0;5;8
"520860 Goianésia";7;2;0;19;0;18;46
"520870 Goiânia";860;145;10;1812;4;4242;7073
"520880 Goianira";9;3;1;40;0;47;100
"520890 Goiás";11;3;0;25;0;55;94
"520910 Goiatuba";10;1;3;18;0;50;82
"520915 Gouvelândia";0;0;0;1;0;2;3
"520920 Guapó";2;2;0;15;0;14;33
"520929 Guaraíta";0;0;0;1;0;0;1
"520940 Guarani de Goiás";0;0;0;0;0;2;2
"520945 Guarinos";0;0;0;2;0;0;2
"520970 Hidrolândia";0;0;0;20;0;20;40
"520980 Hidrolina";1;0;0;0;0;0;1
"520990 Iaciara";0;0;0;2;0;4;6
"520995 Indiara";7;1;0;8;0;7;23
"521000 Inhumas";13;3;0;33;0;52;101
"521010 Ipameri";2;3;1;17;0;14;37
"521015 Ipiranga de Goiás";0;0;0;1;0;0;1
"521020 Iporá";9;1;0;19;0;34;63
"521030 Israelândia";1;0;0;2;0;2;5
"521040 Itaberaí";6;0;0;13;1;16;36
"521056 Itaguari";2;0;0;2;0;3;7
"521060 Itaguaru";0;0;0;1;0;1;2
"521080 Itajá";0;0;0;4;0;6;10
"521090 Itapaci";1;0;0;8;0;15;24
"521100 Itapirapuã";0;0;0;0;0;4;4
"521120 Itapuranga";0;0;1;4;0;9;14
"521130 Itarumã";1;0;0;3;0;4;8
"521140 Itauçu";2;0;0;1;0;9;12
"521150 Itumbiara";109;19;7;89;0;252;476
"521160 Ivolândia";0;0;0;2;0;0;2
"521170 Jandaia";1;0;0;2;0;6;9
"521180 Jaraguá";2;1;0;11;0;16;30
"521190 Jataí";46;24;1;112;0;171;354
"521200 Jaupaci";2;0;0;1;0;1;4
"521205 Jesúpolis";0;0;0;0;0;1;1
"521210 Joviânia";1;0;0;3;0;5;9
"521220 Jussara";4;0;0;19;0;38;61
"521225 Lagoa Santa";1;0;0;4;0;0;5
"521230 Leopoldo de Bulhões";0;0;0;10;0;3;13
"521250 Luziânia";74;20;2;124;1;298;519
"521260 Mairipotaba";0;0;0;3;0;2;5
"521270 Mambaí";1;0;0;1;0;4;6
"521280 Mara Rosa";3;1;0;6;0;4;14
"521290 Marzagão";1;0;0;1;0;2;4
"521295 Matrinchã";1;0;0;1;0;3;5
"521300 Maurilândia";3;1;0;15;0;8;27
"521305 Mimoso de Goiás";0;0;0;1;0;0;1
"521308 Minaçu";4;1;0;9;0;9;23
"521310 Mineiros";13;6;0;45;0;76;140
"521340 Moiporá";0;1;0;0;0;1;2
"521350 Monte Alegre de Goiás";1;1;0;5;0;5;12
"521370 Montes Claros de Goiás";1;0;0;6;0;5;12
"521375 Montividiu";2;1;0;3;0;3;9
"521377 Montividiu do Norte";1;0;0;0;0;0;1
"521380 Morrinhos";24;4;1;69;1;58;157
"521385 Morro Agudo de Goiás";0;0;0;0;0;2;2
"521390 Mossâmedes";1;0;0;1;0;1;3
"521400 Mozarlândia";0;1;0;10;0;11;22
"521405 Mundo Novo";2;0;0;1;0;1;4
"521410 Mutunópolis";0;0;0;4;0;0;4
"521440 Nazário";1;0;0;6;0;4;11
"521450 Nerópolis";7;0;0;25;0;11;43
"521460 Niquelândia";2;1;0;4;0;11;18
"521470 Nova América";0;0;0;1;0;1;2
"521480 Nova Aurora";0;0;0;0;0;2;2
"521483 Nova Crixás";0;1;0;3;0;5;9
"521486 Nova Glória";0;1;0;6;0;4;11
"521487 Nova Iguaçu de Goiás";1;0;0;0;0;0;1
"521490 Nova Roma";0;0;0;1;0;0;1
"521500 Nova Veneza";3;0;0;3;0;2;8
"521520 Novo Brasil";0;0;0;2;0;5;7
"521523 Novo Gama";32;14;3;43;0;86;178
"521525 Novo Planalto";0;0;0;1;0;0;1
"521530 Orizona";4;1;0;5;0;3;13
"521540 Ouro Verde de Goiás";0;0;0;1;0;0;1
"521550 Ouvidor";3;0;0;3;0;3;9
"521560 Padre Bernardo";2;3;0;15;0;14;34
"521565 Palestina de Goiás";1;0;0;1;0;0;2
"521570 Palmeiras de Goiás";3;2;0;12;0;9;26
"521580 Palmelo";2;0;0;0;0;1;3
"521590 Palminópolis";0;0;0;1;0;2;3
"521600 Panamá";1;0;0;1;0;3;5
"521630 Paranaiguara";1;0;0;5;0;3;9
"521640 Paraúna";2;0;0;4;0;6;12
"521645 Perolândia";0;0;0;2;0;0;2
"521680 Petrolina de Goiás";0;0;0;0;0;2;2
"521690 Pilar de Goiás";0;0;0;0;0;1;1
"521710 Piracanjuba";3;2;0;19;0;26;50
"521720 Piranhas";1;1;0;9;0;8;19
"521730 Pirenópolis";6;1;0;15;0;11;33
"521740 Pires do Rio";2;0;0;28;0;30;60
"521760 Planaltina";19;11;0;46;0;83;159
"521770 Pontalina";3;0;0;5;0;13;21
"521800 Porangatu";5;1;0;22;0;25;53
"521805 Porteirão";0;0;0;3;0;5;8
"521810 Portelândia";1;0;0;4;0;2;7
"521830 Posse";5;0;0;13;0;12;30
"521839 Professor Jamil";0;2;0;3;0;12;17
"521850 Quirinópolis";15;4;1;20;0;25;65
"521860 Rialma";2;1;0;7;0;14;24
"521870 Rianápolis";1;1;0;3;0;2;7
"521878 Rio Quente";0;0;0;1;0;2;3
"521880 Rio Verde";58;16;1;96;1;345;517
"521890 Rubiataba";3;1;0;16;0;15;35
"521900 Sanclerlândia";0;0;0;3;0;3;6
"521910 Santa Bárbara de Goiás";1;1;0;9;0;3;14
"521920 Santa Cruz de Goiás";0;0;0;1;0;1;2
"521925 Santa Fé de Goiás";4;1;0;8;0;7;20
"521930 Santa Helena de Goiás";10;4;1;35;0;44;94
"521935 Santa Isabel";0;1;0;0;0;2;3
"521940 Santa Rita do Araguaia";0;1;0;4;0;13;18
"521950 Santa Rosa de Goiás";0;1;0;0;0;2;3
"521960 Santa Tereza de Goiás";0;0;0;1;0;2;3
"521970 Santa Terezinha de Goiás";0;0;0;13;0;7;20
"521971 Santo Antônio da Barra";0;0;0;0;0;1;1
"521973 Santo Antônio de Goiás";0;1;0;3;0;5;9
"521975 Santo Antônio do Descoberto";23;12;0;54;1;91;181
"521980 São Domingos";0;0;0;1;0;0;1
"521990 São Francisco de Goiás";0;0;0;1;0;0;1
"522000 São João d'Aliança";0;0;0;1;0;2;3
"522005 São João da Paraúna";1;0;0;2;0;2;5
"522010 São Luís de Montes Belos";5;0;0;18;0;28;51
"522020 São Miguel do Araguaia";3;0;0;11;0;12;26
"522026 São Miguel do Passa Quatro";1;0;0;0;0;2;3
"522040 São Simão";9;1;0;16;0;24;50
"522045 Senador Canedo";27;13;2;107;1;111;261
"522050 Serranópolis";0;2;0;6;0;7;15
"522060 Silvânia";2;0;0;9;0;11;22
"522068 Simolândia";1;0;0;4;0;4;9
"522100 Taquaral de Goiás";2;0;0;1;0;3;6
"522119 Terezópolis de Goiás";0;0;0;2;0;5;7
"522130 Três Ranchos";0;1;0;3;0;4;8
"522140 Trindade";34;10;0;109;0;173;326
"522145 Trombas";0;0;0;0;0;1;1
"522150 Turvânia";2;0;0;5;0;4;11
"522155 Turvelândia";0;0;0;3;0;5;8
"522160 Uruaçu";8;4;1;27;0;31;71
"522170 Uruana";5;2;0;8;0;9;24
"522180 Urutaí";0;0;0;2;0;2;4
"522185 Valparaíso de Goiás";66;16;3;107;1;182;375
"522190 Varjão";1;0;0;2;0;0;3
"522200 Vianópolis";1;1;0;5;0;7;14
"522205 Vicentinópolis";0;0;0;6;0;6;12
"522220 Vila Boa";0;2;0;12;0;3;17
"522230 Vila Propício";0;1;0;1;0;0;2
"520220 Araguatins (transf. p/TO)";0;0;0;1;0;0;1
"520720 Dois Irmãos (transf. p/TO)";0;0;0;1;0;0;1
"520930 Guaraí (transf. p/TO)";1;0;0;0;0;0;1
"521610 Paraíso do Norte de Goiás (transf. p/TO)";0;0;0;0;0;1;1
"521790 Ponte Alta do Norte (transf. p/TO)";1;0;0;0;0;0;1
"520000 Município ignorado - GO";0;1;0;3;0;7;11
"530010 Brasília";2396;546;38;2692;17;5558;11247
"000000 Ignorado ou exterior";0;0;0;0;0;6;6
"Total";198070;43337;2118;140767;1105;457225;842622
